------EM-|T------X--|-------EB-o---E-|--oT-----oE------E----E------------BB-o-BB-M---E---o--T-----To---M-M----------X----o---X-o-----T---?Moo----B------------------X---------B-----|-?-------o-?-------
----|M----------X-------?M-oTE-XE--B--|BE---EM-Eo--------E-------E---E-E---o--E-?M-------?-MEB------M--?---T------------E-T----X-T--?------B---------o---M-----?----BE|-ME-----B-E--o--|---------X------
----?B-----|--------B-Eo----------?-o-----o---o-o------T------E--TE----?-ME-----?-B-X-T---?oB--X-----------X--M------?----?------------X-EooB-------------?--XT---|M------E----------------E---M--------
---|-o-E-------E----To-B----M--X?------B-----E--E--o-T-----------------TEE--|-?---------X--M-X----|B-X--------B--------------E---|-----ME----o-M-o--o-------?--------------?-o-M-o--X------|------------
-?o--BX---X-----B-B-o--?----E?-M----------------B---X---E--------------E-----M----------------o--T-----X-X------X?--|-----------------B--X----TE-o--EE--M--B-M-M-----X---XX--X---------M---?-M--?---T---
--E----E----B--?-o-M-E-----Xo--o------E-M--B------X?-?XM-?-BX---|-----------|-E----M----B----M--o-B---B-M--?-----|-----B-M--M---M-T-oo-B-oM----|----?--?---o-X-----------M-EB--B-BBo-----?-M---Mo?------
-ET-------o-o----B--X-T-|----EE|----------o--M--X-?o---EX---------X--EB-------------M-?-X-|--B--B---MT--E-EX----|E-M-o-B---o----EX-MX-??o-----B--Bo-|-X-------E-------M--o--B-B-?--------?---BM|--------
-----X|-----EX---?--BET----ME---?--X--E--T----EM---MX--oM---------?---------B--X------B--?-?------MB---------------o---oo--o---|o----------------|--|oE-o--------o---XX------o-B-----B-T-M-ET----------v
-------T----BMX----M----M------X--------X--X----MM-------o--B----o-----M----------E-------?---o--E---------E----E--XM-B--o-----------------?XM------------?------Eo-------o-----o---E--M-----M-?-------f
-|EM----BXM-------E-----E---E?TE---|------M------T|-X----------------------X-XME---------o--?EX---?--BM--M-E-E----ET---?EM-XEB-E----EE-B-M-------B?----M--------o--XB--o-M--T?-M-M-X-----|------?E|-X-Bf
-----|--o?--X--?------T------o----M----------?-ooT-----|-----?----?-o------BBT----B-MBB-M-----E---|--E|------M-?----?---oM-----ooE-M-M------MX---?----BB-MT-o?o----|X-----E--------?o---oX-T--E-?--E---f
--E---------T---X--M--------X-Bo--?------B?E------------Too--B-o------X-XE---?--M---------------------T--E-------T--X----?-----X--XE----E----BX---X--T------M----Bo--ET---X-EE----B---X-------XoM-oB-?-f
-o-------?o-|---B----X--EX?-E---------E--------|------|X??BT---B----M-E-?XE-E-----?B|-X-----|----B----XB-M---M----E---o-o----o----------B-o-------M-BEM----?--X------------T-E|-B-B--??---M---?-B--T---f
-----M-XX----M----?----?---?-----------?------|--M---E----XB-ME-B?--?--X-?----o--------B---------B--o--XT---------T--Xo--o--------X-E--------B--?o--B--M----T------------------X-----------|--o-----E--f
m---M------------Xo-----Xo?-B------------M---------BB-B-X-?-----E--?----M-----oB-|---B-----TM-------T-------?----------X-----------?--?--TE-----B-------?------BB---M--M?---XM---B---------X------B-?--X
XXEX|XXXoXXXoXXXXXX-XXMXXXT?XXXXXBMXXXXXXXBMoXXXXX-EXXoXXXTXXXXXXXoXXXEXXXXXBXXX-?XXMXXXXXX|XXoXXXX-XBXXE?-?-XX|XXXX-XMTXXXXXXX-XE?XXXXXEXX?-XXXXXBEXXXXXXXXXXXXXBXXXXXXX?XXXoXBXXBXXXXE-BXBXBXXXMXEM|BX
