-----MM-----------M----BM-B-----?-E-----|--B-------------oEB---|--------------?--|-?--B-----?---------E---------B-------X--------o--EE-----X--?-------oB-o------o-----TBT--------------M---T--------?|--
---X-----------B----o-T------M-E-E-----?-B--T-X--X--------T-T--BM------T-----------XEo-------oE--M-------|---?B-------o--T-XE--EE|-------o-M----?--o--E-ToE-------------------E---BT---o---------Mo-----
-X---------EM------------------------------M----XB-------------B--ME------------Bo--------TM-|o---|M-----o---------E---|--------?--T--X-----MX--E----X--------Mo-|----oB------------------M---------TM--
---------B--X--o-----o-X---o--o-----M---T-----o--E---M---T--X------T--T---------?-----o----|To---M----M---B----M---M--------------T-oM--?----------o----------T-o-----o----|----B---o----------|-----M--
-Bo-BM--M-|-M----X---?--X--M--T---B----T-----------o------M----T--o----M------B-------?-----E-----E--X?X|---E-M----o--E----|--------E-------------BE-o---Bo----E-XoB--------------M---Bo-------------ET-
-XM--E-?----X--B--BT-E--B-------------oo--X-o-------M?---T-----To-----E--M-X--oE---oo----------E------|--M------T-----o|--------E------To-?----XX---T-------T--B-?-TMT-----------?------|--|----|-------
------X---X----|-o---------M-MX?----------X----B------M--X?-M--E--|-----|----------BX-----M-----?o-------E-M-----------------E----|-------?-------o-o-T----B|------||---X--T--------E----XT--|Mo-----o--
-------o--------------------------Moo------o----------------------ET--B------------TE---EB--|----o-----------Eo---------------|----------------XX---T--o?---Eo--------o--------E--o?-------------------v
---B-E-o-----|-----B---oE-M----E-------------o----T---?----------o-----M----------E-o-----|---?-E------To-MX---T-X----------T-X------------oM|---------------o-o-------|--|--o--M--X-?----------|------f
---E------?--MM----o---E--E-------?----o--------?-M---------?----X--X-------o----------M------X----B-----------------?-o?---------------X--|E-?-----|----|-M-E-----------|o------TE-M-o----?-XM-?---|--f
------M---M-o-------?-o-M-------MM||-------?----------o--------o-M-----?-|---------M-o-o-M|----T---E--------|-----o-M-o----------------------BT-E--E----o-----o--T------Bo-------E---T------|-o----?-T?f
---E-E-|--------TM----------------------?--|-o|-----E-----E-o------|E------M---o----o------------M-------M-E|B--T--?--?-?M-------?-----------------X---T-E--B------------B----BX-----------X-|B--------f
--B-o-T--X---------o|B-----B------B-----X---B---------------X----E---|--------|--|-----T-----------B-E---X---------o--E--B-----------------B-------T-?o-o-----|---o------------BM-|-?--------o|T-------f
--M-------M---T-E---X--?-------E----XX-?--------o--o--------?-------E-----E-M--?--T------------------|----E?---T---B-E-MX----------oE------X----?-E--X--X-----E?-----|oB---------?o?B-----B-T--B--M----f
m-X-----------B--B--?------M-----M----B--E------------T-----------T--X-------------T----M---X-------TX----|--|---MB----B-o------o---E-------B-----o?---?--B--oX----M----T-----XT-T----|---BB---|-M|----X
XXXXXXXXXXXXXXXXXXXXXXXXXXXXXXXXXXXXXXXXXXXXXXXXXXXXXXXXXXXXXXXXXXXXXXXXXXXXXXXXXXXXXXXXXXXXXXXXXXXXXXXXXXXXXXXXXXXXXXXXXXXXXXXXXXXXXXXXXXXXXXXXXXXXXXXXXXXXXXXXXXXXXXXXXXXXXXXXXXXXXXXXXXXXXXXXXXXXXXXX
