--TM-oBB---TBX---EE-M|B|?--E-BXM-|T---E-EE|E-ooT-XoTT--X-BMo---o-?M---o-?---?T--?---o----X-M---o-|T-M?--|T|To--BEMM-M--B|----o-|T----------X--Mo-----E--M-----E-?--M-||T-E-o---o------B-M--EB----T--B---
--------EETE--Mo---o-E----M-M----T-------?--E|-?X--B----MoX---M--B----T--oB|-EXT---M-Mo|--ME----o-----M---M--M---X---o------|----Bo-T---E-T-T--MB-TM?||oo--|--|E----M----X--?-------T---|----Mo---T---?-
-M--o-M-BTX---X-T|E-----?B----XEMoM-E----|X|-T?---oT-----|--|-X---M-|MB---M--o--|MXX--X-MT-E-----E-T--M-X|------To--|?oE-|---X--B-ooMo----?B-E-X-BTE-B--M?--|-?MX-M-E?o-E--?--|---EMEM----ME--X-----E-o-
-M---EM----E-|---E----MM|M--M-B--EX-T?--oBB-E---oMB-E--BX---M-o?---Moo-B----oo-E|--M----M?-o-B-------E|TTXMoToMX----E----M------M--------|-----EB----EXB--|-|o-M-o--------E-----o-BE-o-|----B|-o--o-----
-M-T--|-X--To--?---BBo-ME|--MX-------XoT-MB--?---B|--MT---|E------B?----M--o---EB-B-T-------X-B-X-T-|M-E--Eo-T---E-?-M----MB-----|--oX|-BXB----X?--------oE---X-?----oo--MM-T---E--XEE---oT--T--BXT-To--
-X-|-X---B---o--M-|-EBMM-M----T-TE---X--|M--X---------M--MTB---X-ToM-?TMEM-|------M---E-----|-E-B|X---o-X--TMM|T-ETM?-|T--??---M--E?E-?-?--|?---T-B-------B--T-TM-E----------------B----M|--?o-----o----
--BX-----|------TX----EoB-XXX--T---?----|--T-MEM---B----X----XX--Xo-TT-X--X---?-------B-B------B---X-----X-----EE-BTM-Xo--BT---B--X----XT-MTX-MM--T-MX-Xo-EE|E--E?M-T---E|-||--|--T-M?-E-T-TE-X--BM-E---
--|--||BoM--?--MMX-M?-----XB--o------EE-?----To?-oo--M----|--T------B-TM-o--oT---M--M-oM----ME---TEMB-----------TE--------X--E---?XTM----T-Xo-T-?--------T---?E-o----T|----T-o-|--Mo-E--T|B-??|?XB--|--v
-o----o-----o?E-o?--XE--ME--|?-X?B-----M--EM-M---|XM---XE---B---B----o-TE?-T?-E----E-?-XE--XMT-MT---M-E-?oE-----|---BEM-----B|?------?-EETX----?oM--X-MM--?|---??--oMB-|--B---Xo?X-?o--------o------EMBf
-----ET-----T-?M?-|-o-----o--T--EM-EMT----E-T-EE----XB---?---B-XTXo-B--M----||E-E-??BoE|-----E|--X-E--E----EM----------o----o-T--o-o--T--T---|M|XT----?TEo|------?o-B-M---EE-X--B?T-B--?X--|---T-----T-f
-------E--X---------X---ET---?--o-?|BTB-T-B---------XTM-BMTB--------T--------------BMM--o|--M--XM|------------X--B--o|-|-Xo-M-E-E-----T---X-|---------|-EX--|-M------E--E|-oT?--o--TM-TX-o-?-XXM-Eo--E-f
-?-T-ME|---o---|-X---M-E-----MMT-E|o--M-Bo-|X-M--oo--?M-o-------?T--XB--X-M|-o----XX-------o-EE---M----E-B--EE------XM?---T---MM-EX-XTB|TMMX-T-X--BT-BE---?--T----o-BXM--MX|MTM-o|-XB--?-E--|T--B--E--Tf
-M-E-T---M---M--BoMT-oE-MMM|E--B--B?-------?--B-----BMT-|--E---?o----|E-E--E-?E-M--B---o--|-B--E---EE-TT---o-B--ooEE-|-B-M---B-|----oX---T-B----MB-TM-X?o---?|-?---B-o-M|-EMET--|-X?-----?----X-MBoM--Tf
--|-T-EoM-o-----B-o-B?T---o--M-BB--Mo-?-E--|---?----T-BBMBo-ME--o--T|TT-o-----E---|-------|---M---------BT-EB---E-|-M---?M-B---E---oo--ET|---M-EB--ET--M---o-M---|T---B--M-?EET-X?---M---EXEX-XXETB--X-f
m---BBEX----------??-X|?-M--X-?--B--TEE---B--B-B?-TB--MX-B--M-o-X--?--|X--|-?-E--B|-M----?M----X|TME--?---o---XE--BE|--To--oX|-|---|-M??o-ET---TXE-o----TB-o--EM-o-X--Mo-B--X---|--MBXo-Eo---|EM--B|--XX
XXXXXXXXXXXXXXXXXXXXXXXXXXXXXXXXXXXXXXXXXXXXXXXXXXXXXXXXXXXXXXXXXXXXXXXXXXXXXXXXXXXXXXXXXXXXXXXXXXXXXXXXXXXXXXXXXXXXXXXXXXXXXXXXXXXXXXXXXXXXXXXXXXXXXXXXXXXXXXXXXXXXXXXXXXXXXXXXXXXXXXXXXXXXXXXXXXXXXXXX
