----o-------|---XXM-------------?--o------oBE-------------E----|-B-----B------?----?-------------M----E---o-----B--------------------EX-|--X---|---T---B-o---X--------T--------X---E-MEM------------?---
---X--M------XE-------T---o--M-E-------?-B|-T---------B--------B----T------------------------oE-------EB-----?B-|--------------E---T-M---o------------E--oE--E----------E----------T---o------o--Mo-X---
-----------EM-------?-B--------X------X--?--------------|----|----M--E----X--------B---------|--|--------o--B----M-E---|----------T-----?-----------M---B--------------B---------M--M----XMB------------
------E----oX-------M--------M------M--------Mo--E---M--TT--X--X---T-----------|?---|Bo----|-----M-----T--Bo-----?----------------T-o---?-----M-o-o---------M-T-------o----|-M------o--------|-|--E-----
-Bo-----M-|?---------?-----M--T--X-------TM--E------o----X-----T---?---M------B------??B-------X------?X----E---T-Eo--E-?--|--------E------?-MXMB--E--XT--oE---E-Xo----------|T---M-------------M-------
--M-----B---X--B--B----?-----o-o|--------?---------|-?-------?--o-----E------?-----oo-T-------E-------|-------------------X-T|----------o-?----XXM-ET------BT------TMT-|------------X----M---------T----
------X---X----|-------E-----MX?-------E----B--B----------?E--E-o----T--|---------B----T--------?o--------E-o-----o-------M--E------?--o----------oM-------------B--|---X--TB--------o---X----M---B-----
-------o------------E-----B----E--Mo--E--o------------------M----X-T------T------M--E---EB----E------------E-Eo-----T--M------|---M------------XX----B-o?----o-|---X---E----------o?--T-X------B-------v
---B---o---------------------------o--|--M-------M-----T---------o-----M------X-----o-?-------?----|-B-T-|-------Xo-E----|E---------------EoM----M-------To----o--M?---|-|-----------?-----|--M-|------f
-T--------?EX-M-----------E------------o--------?-M-------|------X----T---------BT----------B--o----E----------------?-------------o---|X--|-X?----o-E--X-T--E--ME--E----|----To-TE-----?--?-XM--------f
-------?--M-o-------?-----------M-||M---B--?-----E----o-o--------M-------|-------X---oXo-M|-----o--E----o-B---B------XoT--B-----oE---X------T-T----E----o-----o--T---M--Bo-----------TBX----|------?--?f
-M-E-E-|----------------------X-------B-?o---o------E-------o------------------o----o----TX-E----M--X---BM-E--M----?----?M------X----?---|BB--------o-------B------------------------------X-----?-----f
--B------X-----X---------------------------o---M?----------------E---------------|----X----X---M--E---------B-----Xo-----B---E-----TE-----------------o-o------------|E-----------|-------B--o|--------f
--M-------M-|---E--BX-----T----E---o-X-?--X-o-X----o-|-----------M--E--T--E-M--?--T--------------TX-------E-------------X?-----------------X--|------X---B|---E-----------------M?o-B--T--B----B-------f
m-X-------BT----------o----M---o-------ooEBT---M------T--o-----------XE-?---------B--E------X--------X-----|-|---MB------o----X-----E?---------------------X-o--T-T--------------T------|-BB---|-M-T---X
XXXXXXXXXXXXXXXXXXXXXXXXXXXXXXXXXXXXXXXXXXXXXXXXXXXXXXXXXXXXXXXXXXXXXXXXXXXXXXXXXXXXXXXXXXXXXXXXXXXXXXXXXXXXXXXXXXXXXXXXXXXXXXXXXXXXXXXXXXXXXXXXXXXXXXXXXXXXXXXXXXXXXXXXXXXXXXXXXXXXXXXXXXXXXXXXXXXXXXXX
