---?---E-------M--E----E-E--E---T--B--BM---X---EB--|---MB----------B--?-Mo---X--B---TM-E--------E-----EE-E?-E-------------?---E-----?--XM---o---------E-To?-----E--oT--T--------?T-EE-o---Xo--E-------o-
--M---------------?E---B---B-E------?--------XE?E-o----o---X----o--------M--E---MM------ME-B--|-------?EX----??------o-E--------|---M-o---XB?----ME--XT-o-E----X----------?---M-M--------------E------o-
--M--------|--M--M------------M--B----?-----M--T---o------E---??o---M--?-BBoX-M-MM-----------?-X--B|?---------X----------B-----E----ooo-----?o---B-XM-------?M------?-----oT--oTM-X------------o--------
-o--?-M--X?--------M--?---X--E------?T---M------X-|-M--E---X-----------------?-EM-o-?|---M--?---XB--?---|--X--M---------X--BE----ME-M--oB----TEXE-X----T-|--BoB-o-X?---?X-EEo-o---T?B--??-XB-M--------X-
-X------------E-B---------X-------|?--o--TXE-----X-To-------------?XB-B-----M-M-o--?-------X--E-M-E---?--T-E-------|--o-----?o-|-MBX--?E|-o-?E----|------?----M--------|M-------E-|T-------o--o---------
--M--M|o|------EE---------?---MXB------------------M-----o-XT---?-X-XE-E-----M--B----|------Bo|-----M------|---o---|--------?|--E------E-To-M----BE---------M------?--E---X----------------------|---?--
---E----X--E----------------------?-----M------o---MBM-?-??--B-------E--MX-M--XB--X-----E--?-X-E--X------------M-?------?-------X-X---oX--X----X-X--oM-?------?-E?---?-M--M----M---X---------X----------
------T-------M---XB--E--M------TE-?--oBT-----X----T----E--M--E-B-?-----M-----X----------To-E|-XM---?--?o-----o--BE----------M-EB---EB-E-o?------oo----------------T----EM-----?-E-------|--E--------o-v
----B-X?--?--B-E--E--M--|-M-MB---M-o--B---B-E--E-------T-----------X------o--M--------M--XB-E-?-?---T------Xo---------X-o---|-M-------------|X---o-----B-E---T---|-B--o----o--M----EX?E-----?------T---f
--M-----?-----ME--Mo--E--?-----B-X--oB-?-X-----T-----?o-o-o-E-X------------?-------|-M----MX|MX-EEE----o--T-------o-o-o?B---------X----B----?---X-X-E-?--------o----E-M-------X------E-?X-o---B--X---|-f
-------oo----E--?--X------X---B----B--X-----?oo--B--?-T-MXo-o|--Bo?-X-|--B--------E-----M-EE-E-MBM-----------E-B--BB---B-o--B----E------X------X-B---?--o---?X--oTo---o-?|--?B-?-------M-------M-X-X-X-f
--M--BB-X-o-------XB-X-M-------------MBT-----M-o---|-??---oT-?M|?XET-T-M---M---M---------EM----|-----?----E--|--?--E---o-?X--B?--B-E----BT--------|-------X---B----X---o-XB----T---TM----T-E-XX--------f
--X----X-o--XE-?---B----|-T-E|----E------E---T--M---E-----o---XMoE--------------M?----B-M------E-B--------M----?BT-BM---B---To----ME----X-?------?----M-------B----o--X--------|-------MX-X--------X?--f
-X--o------E---B--------X----E?-------?---o-T----------E------B|M--?-----B------o--T--M?---EX?M--------------|-------X--?-----?--------E------|-------B-M-M|----B--T------T-----XB-----B-B-M-?--B--XX--f
mM--------X-T-E------o-X---XE---T-?----M------X--X-o---MME----MX----E-M-TE-oo-M---?-|------o--o--X-----E-|---?T?-----X?---M---B---oEoX-MTE----T--T?------------E?--o------MM?|---B---XBT----?o-TMM----oX
XXXXXXMXX|EMX-XXXXo-oXXBXEXXXXXXXXXToXoXEXoXXX-XXXXXoXXXEXBXXXXXXXXXXXXXXXXXTXXXXXXXXXEXXXBXXXXXX?XXXMXXMX-X|XBXXMXoXX-MXXXEEXXXXXXXBXXXM-XMXXXXXXXEXXBXXXXXXXXXXTXXXBXXXXXXXXXBMXXX-|XXXXXMXXXXXXXX-XXX
