----------------------------------------X---------------------------------------------------------------------------------------------------------------------------------------------------------------
-----------------------------------------B---------------------------------------------------------------?----------------------------------------------------------------------------------------------
----------------------------------------------------------------------------------------------------------------------------------------------------------X---------------------------------------------
---------------------------------???--------------------------------------------------------------------------------------------------------------------------------------------------------------------
---------------------------------------------------------------------------------------------------------?-----oX----------------------------------------------------------------------X----------------
-------------------------------------------------------------------------------???M???-------------------------XX--------------X------------------------------------------------------------------?-----
----------------------------------------------------------------------X-----------o---------------------------XXX-?-------------------------------------------------------------------------------------
-------------------M----------------------M--------------------------XX-----------------------------B--------XXXX--------------------------------------------------------------------------------------v
-----------------------------?--------------------------------------XXX------?------------------------------XXXXX----------X-------------------------------?------------------------?------------------f
-------------------------------------------------------------------XXXX------------------------------------XXXXXX---------XX---------------------------------------------------------------------------f
------------------------------------------------------------------XXXXX-----------------------------------XXXXXXX--------XXX---------------------------------------------------------------------------f
------------------------------------------------------X----------XXXXXX----------------------------------XXXXXXXX-------XXXX------------------X-----------------------T--------------------------------f
---------T--------------------XXXXXX----------------------------XXXXXXX---------------------------------XXXXXXXXX------XXXXX-----------X--B--XX-------o---------------|------------------------------T-f
---------|-----------------------------------------------------XXXXXXXX-------------------M---M--------XXXXXXXXXX-----XXXXXX-----------XX---XXX-----------------------|------------------------------|-f
m--------|---------------------X--------------------E---------XXXXXXXXX-----------------------EE------XXXXXXXXXXX---EXXXXXXX-----E-----XXX-XXXX----------E------------|----E-----E-------------------|-X
X----XXXX|XXXXXXXXXXXXXXXXXXXXXXXXXXXXXXXXXXXXXXXXXXXXX------XXXXXXXXXXXXXXXXXXXXXXXXXXXXXXXXXXXX----XXXXXXXXXXXXXXXXXXXXXXX------XXXXXXXXXXXXXXXXXXXXXXXXXXXXXXXXXXXX|XXXXXXX----XXXXXXXXXXXXXXXXXXX|XX
