--?M-oX-X?---X---E--o|--M?-E-EXM--T--Mo-E-|---o?-X---EB--B-----oB?-oE-oMM---?M|-?---o--|-|---M-M--T-M--BXXX---E-EMo-|o-B----B--|TX----T-BB-X----------|-EM|--?EE--|M?|?M-o|o|----------T-----M||-T-XXX--
--|---X-|B-E--M----o-E---|Bo-X------E----?-ME|ToX--B----?--X---?----?-TM-oB---o--X--EMoX---EX--Bo--TMTM----E-----T---M--X-T------oo-E-T---T----M|-EMB|E-o---o--------o--------|--B-E-E--|--?--o---TT--?-
-M--o------M--X--|E----E-EMT----EoM?EE---|X-?-----oT---T---M------TT|MB--?-o-----oXX-MXXM---------E|--M-XB------T---|-|M--X--X-XM?X-M--?-M?----X-BT|---B-E--B-MMX----?-----?-ME---EME--------M|---T-E-X-
-M---oM-|B---|---E-o-EM-----o-E--M?-X?--o---E-B--M--||-MXX--M-o------B--E---oo-E|--M---X|?-o-?--T-----|-TEMBT-MMB--oEX---M---T--M-----o--|--------T--oX-E-|-|--M-o-E|-B---E--X--B-EE---M-o---|-oE-o-|---
-M-|--TB---ME-X?--Xoo---E|T-o---------TTTM---B--?B---X----|EB-----X?M---MXE----|T-B-?-------|--E?--B|M-E-?Eo|E-----?-|-----BT---?|-T-XE--BM--o-X-X---|---XE---o----B---|o-Mo--?-E----EBM----o?M---B-----
-M--o|?|-B-X-oo-M--Eo--M-?----T--o------|M-?----M-----M-oMTB-?--B----?--oM--------M----T-M----EX-|X---o-X---M-?--M--?-ET---XBXX--oE---???--T?--XT|----|--?B-BM----EXM|--M-?E-T----------M----o--?-------
--?X-----|-T-T--TX----B-M---X-oTT-B-------MTM-E---o-o----?-E---E-Xo-TT-X----E-?---||---MB------B---|--|--oETM---E-|MM-|o-ET-E--B------EMT-MTB----------X-?-B--M---??T--E--Bo-T-|?--TM?-E----E-XE--|-----
--|M-|?BoMX-EMo--XTM----o--oT----o-?--E-XM?--X-?-ooXM---o-E--T---MX-o-X-----oT---M-----M-----B---T-M-MXoB---M--o-EB-X-XE--------oEX-o-----TX-||-?-----X--T-M-XE-------|--------EE--o-E-E-T---T|--B--?-Mv
-o-Mo|oE---Eo?--|?-----o-E---?|XTB-?---XM--B-M-o--XM---X---TT?--E---?o-EEMBTMME--MX---?-E--Xo------TX--o-o??M---X--TMMM---?---?E-----BME-To|--X?--|-X-M---??---??-BBEBM---B---?ET?-?o--B----Bo------EEBf
---o--T|---oT--o--|----T-------MTo-EMX--E-Eo--E--M-------?---o-XT?o---Eo-T--------?-BoE--?----Eoo--M?-||-------X-M----|?----TM---o-M--B-XTT---M-XT-M--?T--|-----T----TM------X---?oEB--?B-M|--?---TE|--f
-o-B-o-E--X-?---E|--X---M--E----X-?BET-?T---B----T----B-oM-?------oM?TMT-XE-----?M-BoE--o--o--MXM|---X--------M---MMo--|-X--MX-?-?----TX----M-Eo-M---B-----|----B-E--E-EM-oMT---oX-X--oX-o?-o-----o-oEof
--MTBMEo------M|-|-|-?--?----EMTT---|EM?Bo-|--M--oo--?M-o?----o|-B-oT--|--T--o-|--X------M--|-E-E-M----E---M-Eo--Xo-o---B-M-E---TE--X-EET--E-T--?MBB---M--E-XTM--T--|X--BM?|-T-T-|----M--E---T--B--EB-Tf
-MM------M---MB-EoBT-oE--M--E--X?-B------BE---|--M--E-T-|--B-X---M--T||-E-XEE?E---|-?EBo-B|?B--T---EB?-|-----TET-o--?-EBEo--T?-|----oXo--TE-|T--MB-T--X?o-BTB--X--BB---------|--X--E-----?----E-?-To--Tf
----|-E-MEoB|---B-ooBoT--MoBTM-B----X-?-EEo|-o-?-----EBEBXo-MT---T-||T--oTM-?----oo--B--|---o--E-----MB-B---E-----------oo|--o-BE--o------|--B--E-||-|-M---o-MB--M?---BX-M-?EEE|X?--MMB---XE---X--|---Tf
mB----EX---|------??TX|---Mo--Bo-B-X--E-TEB-oo-BM-|-M-MX-T---?BT---E--|--?----E--T--MTTXM-M-----||-E---|E-oB--X--oB||--Xo-?oXXMo---|oM-oo-?T---TXEBT----T--X--MM-oM------BT------X-MMX-?EoT---EMX-B-B-XX
XXXXXXXXXXXXXXXXXXXXXXXXXXXXXXXXXXXXXXXXXXXXXXXXXXXXXXXXXXXXXXXXXXXXXXXXXXXXXXXXXXXXXXXXXXXXXXXXXXXXXXXXXXXXXXXXXXXXXXXXXXXXXXXXXXXXXXXXXXXXXXXXXXXXXXXXXXXXXXXXXXXXXXXXXXXXXXXXXXXXXXXXXXXXXXXXXXXXXXXX
