--------oB---|--o---?--------|-o----------X---E-M----------o--X----X?---E----M--X--Bo-BT-o-ET?-X-oo-------B-E---M-B-XE---|o-M-o----o---|Mo--?--E-E?--ME-M-B--M---o-B----------------?-T|-X----o--o--?-X-
-X----E--X--E--X--Mo------?E?EM-----B-E-------|-----o-?---------------M---Boo----E------o-X-X--MBToo---E-X-----X--X-E--oEB??X-----X-----X---------TE---BB----MMBE---X-------|XM-X--o-Mo-------------T---
------E----------------M?---E-----o-oE-T-|-BB--TT-M-?B----MEM-XB---E-o-EM--X-M---Bo--o---------E--X-----X--B--X--B--E-?---------M---X--?M-M----?----------o---|-----?EX--E-M---?-------M-----XEM--M-B---
--E-----BX-----B--MooM--|------XB---|B|?-------M---B-M---X--XoE--oX--X----?--X---T---|---?-M-o----X--B----X--M-?-B-----?E----?BB?o------E-X|MX------B-----|M------T-B-----B-o?----?-------BT------o---M-
------o-o---M--T-XM--B-o--B-----X--E---?---E--o---o---?---E?---oM-M-T-B---X|----M---EMXE-o----?-----T-------E---?-TE-oE--?-M----XEMX?-B-o--Xo---o-----X-MT-o---TT-?---oB-?-M---?-----BoB--o-------MX-|?-
-o---?----X?-X|?---------?----o--E-?----o---B---o--------?M|TX--X--------o------XX-------E-|--TB-o-XB-------EBX-X-?----M-M-|-------B--?M--E-EX-E-?T----o-MX----|---BEM-|-|-----X-----?------E----M-B--X-
-|-E-|--M---M-o--X--o-T|-E------X-----E--?---------o----|?|--------?--------------------------X--------B---------M-X----oB-----B|-E-------?----|E-?-M--o--o-o-E---E--------------EM----B----MB--?EX?----
--|--o--EM--o--|------B-|--------MMX----M------XM-?-o--E------B-XT------------B---------E-oE--Eo-M-----TE--X---?-M--E---T-?BT---B--|----E|------B|---E----M----?----M--B-----?---EE-M-------------o-o--v
--?Xo---M---?BM----B--o--T--|-----X-T------X------E-X--------M-M---o-E-----B--E--B-M-M--E--XM--M?-----X-?--oM-T----------M---?--oE?M-?--|-T---|-B---X-EEM---M------T--------X-----B--?M------EB----M---f
-B-M--B-XM--X---M--------|-T--?-M------XB------B--|--?--|---E--B------M-M---M--o-MX-E--------o-B-------B----B---|-oE--MT---Xo-B-?-E-?--XB------E--X------M-E--M----oE-MB---X-B-------?----X-----?-M---?f
--------Bo-EEE------o-XB--Xo-X---o-X---?-----E--?-XB--?--?---E-M--E-B---?---XE----E-----M----MEMo-MM----oX-o-------B-oXB--------X-B-E---?-M-|MoEX-------o---?-E-EB--E|--B--?E------------E-------B-----f
--B-------o--XM----BE--B------?--E--|--Eo-M--?-M---B-|-o------------TM-Bo-M-o-T------?B--o-------?-oE----M------------E-E------M-o----ME---M-X--X-------??ME-E--E?----|-|--MoX--------?---|oXXE------EMf
--EM---X--M---??--E---E-M|----?---E---Eo-?--------M----?B-------M----?-M-----X---B-----T|Xo-B--ETXXX-B|--?-------o------B---X---B-----B---X-T--E--B-?B-B--------T--o--T-M-M----o--M---TBBB?|--?E-------f
---T-------------E--------o--EBM-|--X-EM-B--E?o---M--oT---MT-------X--E-oTM----B----?--X---X----o-----------T-X--------E---------?o-E---E-T----X------|-?-EB---?-oo-B---o-X--M------B--------------?-o-f
m--|---?---M---E-------E---o------|BMT-?E?-------M-B--M--M-|---?-XB----EBo-B-T----?XB-----o--EB------?-o-o-M-Bo-B?-----?B---X?----oE-X----X-B-?----------XM--M-E--TB-----BX-X-----X---X--M---X---X-B--EX
XXMX?XB?MXXXX-EXBBXXXXoXEXXBX-XX|XXXXXXXXXXE?XXXXXXXXX-MXXXXX?MXXX|XXX-XXB-XXXXXXXXo-XXEXEoXXXXXXXXXTXXXXMXXX??XXXXXXX|XXo-EXX?XEXXXXXEXEMXXXXXMXXXXXX-XXMXXBX?XXEE-XXMXX|XXXXTXMXXXXo|MXXXXXXXXXX-Xo-|X
