--o----E--------o?--M--E---------------------TB--?M--------o--------------M--X-----o----M--T---|-?-||M------EB----------------oX---X----M-----?-------E---------E------------------B---X--X----------T--
--B--------TE---|-----E---------------M---B-|XE--EM---?-?B--|--T---------M----M-M--?-E-|-B-B-------??--E-----------------?-----E----M-o-X----X------o--XM-?----X--------------B|-----?----M----E------E-
------T-----o-?--T-----------X------B------------?-------------------------M-----T------B------|M--B?-----X-----------M-------------------?--X--------------?M----?-------B---o-o-XX-----|--------------
-o-o-----X-----BM-|M--?-|--M---?--X--M----------?--|M---XX?--------?--E--T-M-?---T---B---|--?------T-------X--T--o----------------oMM----------X-?---------MB-E-M--?---------------------o-B--------B---
-X?-----------Mo----T?E--------E---o--T--B--M-------o-?---------?-EX-o-?-------------T----|---?-B----?--------------M---T---?-XX---X-?-------T------o-ETM----oX----------?----BoE-o--------------?------
------------T---X-B---?-------M-B--X-----E--X-----o---?--o-E---o?-T--E-E-----M?-BX---Mo-------o-E-?--------|o----------|----o---E----|--XXo-M-----?--X-T--BM----|-T--E-?oB---------------T-----------B|-
------o---|EE------------o-----T--T-----M------M-----M-------X-BT---B--X-X|---X|-B------E--?-MM---------------TMo?-X----B-------X-----?-M----E--?X--|----T------B------BB---------o---oX--------------o-
--------?-----E---------TM-E-------?----|-------M--E--E---o---o---?--E-X-BM-----------------EE-o----X--E---|-----|---|------?M-E-X------------------|---------X---------EM?o-----E|---------|-||--M?---v
------X------?-E--EoB-----M-------------------B------------M---E---------|-?---T---------XB----MT----------------B----------M--B-T-----------M|Eoo------------E--B-B-----o------------T---T-o----o-B--of
-------X-|X-----------X-|-----------E-T?--B--E-|-------|X-----E---|X---ETE--o--------X-o------------|-|M--B---------------------o---E--B---B----T-X-o|M-------o-X-BEEBM----------------?--?--X---------f
--------o---M---------------T--X|---------B--o------?----------M--?-XB?-----EB------T---M-E-----B---To-Bo--o-M----B----X-----EoB-E-----|---BE---E----X----B-?---o--o--o--?BX---E--------B------?-T---X-f
--MT-B----o--E----Mo-----?------E------------?-|-B-|----X-o---M-?-E--BX--------MMo--B-TE-E---o------------E--M-o-o-E------X--B--BB-M--M--M----------------?-------------BX-------?---M-----E-X-?---o---f
-------M-o-?---T-----|-E-----------B---o?-------M---E-E-----o-o-o----------------M?-o-?-----X--E-XB---M---B-------------B-------|-E---M---M------?----?------E----Bo----X|-----E------B---?-?----o----Tf
----T-MX-----------------?----------------BX--X----T---------?--M---------?---------o------XX-E-----o-?---B--|-----|X---------?-----?M------oo-------X--M--B----B--oE---------E-B----M----T--------?---f
m------|B------?---B-o-----M--E---?------o---o-----o-------X---X----E-T--?|---B-M?-----T------o--------o-o-------------?------------o--E--B--?----?-X-----------?--oB----?------BBTT-------M----?X-?---X
X-XXX|MXXXBEXEXXXXXXXXXBXXXXX?XXX-XXXXoXEXoXXXXX?-XX?X-MXXXXXXEX-EXXMXXXXX-XXXXXXXXXXXXX|XXX-XXXXBXXETXXXXoXXXTTXXXXBXXXXXBEXBXX-XXXX|XXXoXXXXXXXXXXXXXXXXXXXXXXXEX-XXXXEXXXXX?BMXXXXX?EXXEXXXXXXXXX--XX
