-?-T--?--o-----------------X-----T------------?--?----|-----------?E---o-|TT--?---?o---------|-----?-?BX-o---oMT---XE-E---?--M-------o-M|---T??-----BM-|BMX-T-----B---------o-----o---o---X------|----X-
-T-E------------oToT-X----B--?-B--B-M------B----E------o---E-X---o-----B-M------E-B-MoTE------|--TX?---B----B|-------X--?------------X-o-BM----T--oM--------B--BX-----M-B----E--o----E--E---E---X-------
---?--------?-----T--B-------X------X?||-?----B-M-B------E------X-----M-M--------------T-------|------------EB-?T------?----?BXBoMB------o----o--------------M-M--------M----------------X--B-|----Xo-T-
-?-----ME-M-B-M---------X-------?---------M-B---E--X--|-T----T--o--------E---T------o-----o-T--B--E-?--------------E----|--B------B------X----|----E----E-M-M----M---X--B-|--?--------?---oTX---?-B-----
-E-?M-?o-------o------------E---B------o--E-----------EM?B---------E?T?-E---|--E--B------X-B--E--E-----------E---B-------EET---BBB----BoXo--|--X-----|--o------?------------o---?-?---------XM----E-||--
------ET--M-B-M--B-----------oT---o--M|----?BXX--M---MTE?--X-Boo?o?-E----|----M---------B---o--|--|B----M---------|-----X-X--B---------M-----?---------T-T-----EE----X--------M-M----M-o-?--X---o-o-----
----?X------?B-|------------o-----TE---B-MX-o------------o----E-TXMM---EE--------BB--M---T-----------M-------M-Bo------------?--B--------E---EoX-MM-Xo--B------?|X---ME-?----X----?-T------|o-------E-T-
----oXT---?-------E-|-XME-E------------?M-M-M-----------M--B?----M?-------X----X----------oo|---|X-------X----T-----o---?-|-----oE---BB----E--X---------EXEX-B---B|?--XE-------BX------MX--?-----X?M---v
----?o----o-E---------?-MB----M----?----X---X--ET-E---?------E------|-o-B--------?---------E-Bo----?--M-------E--B-M---------X--E---?-BBo|-EE----o----|-o---------o---?-----?--MX-X---E------?---X----Mf
---------------o--X---------------|-E-XM--?--E--BB-E|---E-E---BM--------E--------?-X--E-----Mo--------o-----------B------M-?--------?--B---|----?---?---oM-MX---X-|---E--o---B?-o--oo--|-----BM--------f
---B--?----?--------------TE-------X--E-?----o----E---Eo---o-E-o---?--o---M-------E----M---o?BMB-?B-B-?-----X-EX-----E-o----M---MB---M-MXoX-?---?------------T---------BX---X-------------XE--B?|o|--?-f
--T?--------------M---o-----oB--Moo-o-?--------?-T----BM---M--E-------E--B-------X--MX---X-X------M-M--o-B-----XE------------|-T-?----?--o-|?---X---?--?-----------?-|B----X-M-T---?-MM-----M--E-----E-f
------BB---------E----B---E-X--|EEB--M--?------T----X-T--|-----------|-----------?------T?MM---X----E?---X-----o---?T?M----B---Moo--M--o--E--------T-------?-----MB----?------?-----?X-TE-?-BB--?----B-f
-------M--B-X---X-o--?E--BX------B-------oX------M--|----T--X---T-B--------EoT--MEo--M-M------B-?-------|--X--E---o-M--------E--E-X--M--T---|--MB-|--E---oo----?-B-?-------?Bo------M--X-X----M--B-M-X-f
m--M---?MX---o-?----------------|---o-MB--M----B----M---?---B--BM-?----oo------------E--X---------|---?-o------X----|--?--?-B----T--------EB---BBT-X----o-?-Xo----E---E--M----X-------------?-----T-B-XX
XX--XXXXXXXXXX--?EXX?-XXX|XXXXXXXBEXXXXXXXXXXXXX-XMoXXXMXXTX-XXTXMXXXXXXX?oXXXX?XXXXXXBXXXEXXTo-XXXXXXXXXBXTXX?MXXXoXXXXXXXX-XXMXBXXXXXXXXX-?XXXXXBXXXXXBXBXXXXXTXX-XXMXEoM?EXXXMXXXoXXXXXEXM-XXX?XBXX-X
