-X--o-M---------XXM--B----------?--o-T----oBE-------------E------------B------?----?E-----------------Eo--o--------------------------EX----X-------TE----o---X--------T--------X---E--EM---T---|----?---
------M------XE--------|--o--M---------?--|-T---------B--------BM---T----------o-----------M-o-------BEB------B-|----T---------E-----M---o-M----------E--oE--E----------E-------E------o---o--o-E-o-X---
-----------EM----M--?-B-----o--X--?---X--?--------------|---T|----M--E-------------B----|-------|--------o--B----M-E-|-|----E-----T----------------BM------------------B----B----M--M----XMB------------
---------B----------M--------M---------------Mo--E------TT-----X---------------|?---|Bo----|-----M-|-------o----o?------------|---T-o---?-----M-----------M-M-T-o-----o----|-M-MB------------|-|--E-----
-Bo-----M-|?--E------?----EM--TM-X--------M--EM--T--o----X-----T--o--|-M-----o-------??B-------X------?X----E---T-Eo----?-B|--------E------?-MXM-E-E-oX----E---E-X--|--------|T-T-M-------------M----E--
--------B---X-E--------?-----o-o|-----o--?-------T-|-?---------------TE-----X?------o-T-----------E-------------T-----o|--X-----------B---?----XXM-ET------BT------TMT-------|-?----X--------M-M---T----
------X---XB---|------------TMX?----M--E----B--B---B------?E--E-o----T--|--------------T---------o-----T--E-------o-------M--E------?--o---------MoMo--?-----T---B---------TB--------o---XT---M---B-|---
-------o------------E----------E---o-----o-o----------------M-----------E-T------M--E---E-----E--------------Eo-----T--M----------M------------XX--B-B--?----o-|-------E----o-----o?----X-?----B-------v
-------o-o----------------------|--oE-|-XM-------M---------------o------------------o-?------------|-B-T-|-----T-X--------E-T--------------o-----M--E-----o----o--M----|-|-----------?-----|--M--------f
-T----------X-M-----------E------------o------|---M----|o-|-?----X--------------BT-------------o-----------------------o?B------------o-X--|-X?----o|E--X-TM----ME--E----|----To-T----o-?----XM--------f
----E--?T-M---------?---------B-M-|-M---B--?-----E-?--o-o--------M-------|--M----X---oXo-M-|-B--o--E---E--B----------XoT--B-----oEM--X--??T-T-T----E-----|-------T---M--Bo---|-------T------|---o--?-T?f
---E---|----------------X----------------------M----------E-o------------------------M---TX-E----M------B--E------??----?M------X----?---|----------o-------B------------------------------X-----?-----f
--B------------X-----------B---------------o---M?-----E----------E---|---o-------|----X----X---MB-E---------B-----Xo-----B---E--|--T-------------M----o-o--|--------||---T--------|-------B--o|--------f
------------|---E--BX-----T---|----o-X----X-o-X----o-|-----------M--E-------M--?--T-o-----------B-X------?----T---------X?-----------------X--|------X---B|---E---X----------X--M?o-B--T-------B-------f
m-X--?----BT----------o----M---o-------o--BT---M---------o-------|---XE-?-----------TE|------------?-X-----|-----M---B--|o----X-----E?-----|B--------|-----XX---T--------X----X---------|-BB---|-------X
XXXXXXXXXXXXXXXXXXXXXXXXXXXXXXXXXXXXXXXXXXXXXXXXXXXXXXXXXXXXXXXXXXXXXXXXXXXXXXXXXXXXXXXXXXXXXXXXXXXXXXXXXXXXXXXXXXXXXXXXXXXXXXXXXXXXXXXXXXXXXXXXXXXXXXXXXXXXXXXXXXXXXXXXXXXXXXXXXXXXXXXXXXXXXXXXXXXXXXXX
