--T--oX-X--T--|--EE-MTB|??-E-BXM-----ME---|E--o--?oTT-B--B-oX-MBB?-oE-oM?--B?M|-?------|-M-M-M-o-|T-M--B|X|---E-ET---o-BT-T-|o--T-------BT---MM---------MX----E---?M?B|B-E??|--oXX---------EBM|-----EX--
------M-EB----MX|--o-EE---B-M----T--B--|E?--E|T?o--B----M--XX--?--M-M-T--o|--Mo--X--EMoE---E----|--TM-M---B----------T--?--------oM-T-----T----M|-TM--?-E------E----Mo---T--?--ooB-ET--E----?Mo---T---?-
-M--o-M---?M--X--|------?-M------oM--EE--|X?--?-XMoT---TB|--|-----T--MB-o?M--o----oX-MXXMoME---|-BET--M--|----|-------oE-X---E--M?X-|o-?-M?----X-BoE--------|---X----?E----?-o|--XEXEX-----?EB|-------X-
--|-M-M------|-----X--MM----M-E-?----?-oo-B-T-B--M-ME--BX|-EM-oT---M-o------oo-M|T-M--T-M?|o-?---------MT-Mo?--MB--oEXB--M------MTE-o--B-|X-M--?B--B-EX---|-|----X--|-B---Eo-X-oB-BE---|-ET-B--oE---?---
-M-o--TBX---o--?--Xoo|--E|--M-----T--?o--M---X-X-|-XB|----|EB-----Mo---MM------?T-B-?------?X--E--T-B--E---o-E---E---M----MBT----|--B---BXM--o----M--|M--X----M---|---o-oXM--?--E--XE-B-?------B----T---
-X--o-?---E-Mo--M-M-EMMM-M---oT-TT---B--|M-?------M---M--|-B-E-XBT-M-?-MEM-|-B----M-XME--M-o--E--|X---X-X--|M--T-XTM?-|T---X---M-oX---?-?--T?---TM-M------B----BM-E-B----X--TT---E-B----M|o---B---------
--BX-----|-|---XTX----ooBTXXX-oT--B?E-----?TX-MM----E--B-?-E---EEX?--T-X------?----|----Eo-----B----o---Eo------T-BM---o--T-------T----MT-M-M--M--T--B-X--EE-E--o--?------M|------TT??------E-XE--E-|---
--|M-|?BoM--?X---X-M--E---Xo-B---------T?----X-?-Eo--M--o-|--T---MX-?-BX---?o----M--MMoM----MB---TE-B---E---?--o-EBM---------E--B?-T-------?o|X-T--oB-X----T-XET------M----T-|-Eo--o-E-E-|--?B|?X?-----v
-o---|-E---Xo?-M|?------M--M|?|X?B-X---M--EM-M|-o-XM-------TT---?---?--TEM--?ME-E-X---?oE--XM-EM--o-X-E-|o?-----BM--?E--------?--------E-oX|o---oM--|-ME--??-M-??-BB-B----B-B--ETX-?o--B--M-Xo-o---M-MBf
---o---||--oTo-M?---B--T--oM-T--TM-EMB--E-----EE--------B?---B--XXo---EM--------E-?-B--|-|-T-BEoo-X|-||----ME--XMM----|?-?---MT----o--B--T---|--XT-M---T-o|-T--------XME--Eo-X-M-?T-B--?X-M|-----TTE-T-f
-o-?E--E--E-----E|E-o---E--E-E-X-|||--B?T-Bo-----T--oTB--M-X--------?-M------|-|---BoE--o|-oM-MXM|---T--------X---MX?--|?|o?M----?----TX--X---EXM|--o-?-E---|MX------E--MEo-TB---X-TMBT--o--B--M-E--oE?f
----BMX----o---T-|o--?-E-----MM-TM-M|-----?||-ME-oTM--M-EXE---o|-B-oT-B-X-T--M---?-X--------|EE---M--|---B-oooo--X---M?-B-T------|--X-E-MM-X-T-X-MBB---M--E--TM-M---BX---?X|M--T-|-X---?-E--|T-BB--EE-Tf
---E-----M--X-B-B--T-oE--MM----X?--?------E?--|-----EMTXX--T-X---ME-T|E---XE-?X----T-BB---|?B--E-------||B-o-BEToXE-?--BEB---BE-----E-o----B-E--MBoT--X-X---B|-?-E?B---M-|BME---X-X--|---?----X-E--o--Tf
--|-T-E-M-oB|---B-o-BoTB-MoXTM-B--T-X-?-EEo|-o-------EBBMBo-ME--oT-B|TT-o-Mo--EM-oo-----|-|---MEo-------|---B---E-|-----B--B-B-----oo--M-----MEEB--oT?-M---o------?E--B--M-?EBE-----?MB---TX---?-T----Tf
mB--BB--------B---?--X|?--M---B-----TE-ETEB--o--?-ToE-M--TTBM?o-X--EM-|--M?E--E--T|-MT---?------||ME----?-oB-EXE-|-E|?--E--oXB-E---|-M-?o-------MEBo----TB--------MX-----B---|--|XMMMXB--oT-B-EM--BXB-XX
XXXXXXXXXXXXXXXXXXXXXXXXXXXXXXXXXXXXXXXXXXXXXXXXXXXXXXXXXXXXXXXXXXXXXXXXXXXXXXXXXXXXXXXXXXXXXXXXXXXXXXXXXXXXXXXXXXXXXXXXXXXXXXXXXXXXXXXXXXXXXXXXXXXXXXXXXXXXXXXXXXXXXXXXXXXXXXXXXXXXXXXXXXXXXXXXXXXXXXXX
