--TM-oB----TBX------T-B|?--E-BXM-|---M---EBE-oo--Bo-TE--BBMoE-MB--M-E?o-o---?T|-M------B-M-M-M-o--T-M?-BXTXT----?MM-M--B|---Bo?-T-------B--B--Mo-|-|T-||-X|---EX?-|--||ToE??B--oX-----B-M--E--|-----EX--
------X--TT---MX---o-o---|BoM-------E----o--E|-?X----E--Mo--X-M--B--M-B---B|--o------o-|---B--T-|-|---M----------E--Xo-?----BE----M------------M|-EM--B-Eo-----E--EoM-o--ME-?---oB-ETE--|---?Mo---B---?-
-M--o-T--T?M--|?-|E-X---?E-T----MoM?-----B-|-----Mo--X-------E----MT-MB-o?M--o----o--MXX|o-E-----EE---M--|------T---|?|M-|---B--B?X-Mo---B?B---X-BTE-T-BM---B--MX-M-EBE---M?--|E--EMEM-X------|---T---X-
-M---EMX|----|--------?M--?-T-E-----M--ooBB-E-B--MB-E---X--EM-oT-----o--E|X-oo-E|Xo|--T-MT---?---------TTXMo--MXBo-oEXB--M--?B--M-----oB-|-----?--E--MXB--EM|--M-M--|-B---E-----B-EETM-M-ETEB--oE-o-----
-M-T|-|BX-ETo----X-Boo-ME-T-MX-------|-T-MBX-B---||--M----|EB-----X-M---MX-o-X-|T-B--B-----?X-BE?-T-BM-E--Eo-E---E---M----M-o---?|-To-|-B-|E----TM--??-|-o----M----B-oo--?B-T-------E---?o------B-B-T---
--X|BX-|---MMoo-M---EM-M-M---oM-TE---B-E|M-?X-----M---MT-MT---?X-XoM-?TXEM-|-B----M-X-E--M----E--||---X-----M?|T-MBM?B|T---XB-X--oE-E-?|?--T?----M-M-X----B---------E-------?T-----B----M|---oB||--o----
--BX-----|-------X-?--EoB-XXX--T--B?----|-MTBMEM--o-E--B---E----EX?-TT-X-|------------B-B--M---BE--Xo----o--M--??-|T----?-TT---B--X---E-T|M-X--M|----B-Xo-EE|E-|-M--T--E||Mo|--|?X??o?EE----EE---B--?---
--|M-|-Boo-M?M---MX-?-----XB-B-----E--E-?M---T-?-o--MM--o?|MX---XMo-o-BM-o-?-T---T-----M-----B----EMB-----|----M-EBM-o-E--X-?E---?XT--M----X--|-?-----X--T-M|?E-o---?T|--T-T---E-----E---To-?B|?XB--|-Mv
-o-----EE--X--EM|?--|E--M--E-?|X?------M----M-----XM---X---TT--B?---Eo-T--BToME-E-------E--o?-E-----X-M-?--?T-------?EM-----?-?E-------E-TX|-BX-oT--B-M-X-??---??oBBEB--------X-?X?-B--B-----?------EMBf
-----ET|---oT|-M?-|----X--o----MBo-TMX-oET?B--EE-M--XB--B?---BoX-X----Eo---B--E---??-oE|E-E--BEo-T-|X|-----MM--X-M-----?-?-o--M----o-MB---TE-|M----M------|----------XME--EE|X-MB?T-B--?XoM------T-B|M-f
--MBT--E--X---o---EBo---ET-E-E----?|BTBET|B-B----TX-XoBB-MTX--E-----T-MT-XE---T--?--oM---|-o-BM-------?-------X--oMX?|-|?|-?M-X-E------X------------M-|TE-?o-|-------E----o--B--o--XM-T-----B-?M----XE?f
------Eo-------|-Xo--?X------MMT--|--E-?B--|X||o-MM---M-oX------?B-oXBB-X-MX-ME|--XT------MoXE-------|TE---MEo-E--o-o-----ME-?-M-EX--T-|MM---T----BT-BEM-T?-BTT-M---BXM---X|MT---|-X--M?-E-T-T--Bo-EE--f
---E-T---M----B-Eo---oE--MM-E--B---?--T----X-BB----oEM--X-------oME---|-E--E-?E---|T---oE-|?B-----TE-------o-B---o--?|-ooEo----|--|-oX---T---E--MBoT-BX?X--?B|--B--B-o-M--EMo-X-X-B?---T-?--E-M-E-TM--Tf
-||-----o-MX----B-o-B-T--B-XTE-B----------o--o-?----TEB?TBo-ME-----E|TX-----?-EM-o|-----------ME------B-B---B---E-|-M-M-BM|B-B--E--To---TT---BEEB--EM|-M----|-o---T---BX-M---BT-----?MB--EXEX--?-----XTf
m----BEX------B-T-???X|?--M-X-?--BX-TEE-|-B--B-?M-T-E-M----XM?BTX--?-X|X-?|---E--B|EMT--M-M-----BM----?-?-o----E-|B||XX-oX?oX|ME---|-M??o--E---XXEBo---?T------M-o-X---o-TT-------MMBXo--oT-B-EM--BXBX-X
XXXXXXXXXXXXXXXXXXXXXXXXXXXXXXXXXXXXXXXXXXXXXXXXXXXXXXXXXXXXXXXXXXXXXXXXXXXXXXXXXXXXXXXXXXXXXXXXXXXXXXXXXXXXXXXXXXXXXXXXXXXXXXXXXXXXXXXXXXXXXXXXXXXXXXXXXXXXXXXXXXXXXXXXXXXXXXXXXXXXXXXXXXXXXXXXXXXXXXXX
