-?----M------MM-B--oT-E--?M--------ME---XT---T-o----|---|----?--o-MBo---X--|----T-EE------M-EXE-E-?--|----o-----XBETX--?|----B|Bo---E---BEX--------Bo-TMT---MX---E-?BEX-X---B---T---XMB-|----?M---------
--oX?E--T-----|-?---|--|--XB-XM--XX----X--o--M--o?-|-|-E?--------T-X-o-E-----oMMoT-B-X---To---B------?----T-----T-?-E----M--------?-MB----oB----|--XE-?-------o-EMM-E-E-?---?----XT------?|--E----TX--B-
-E-XMB---?-E----?--Xoo-??---T-XTM--|E----B-----BoM-o|E-|MXM-E?----M----T-XT--M---|----B|-?BE-X|----T-X-o-o-oo---?--BE-M-?E-MX-XMTM--o--BM-BM--?o----X?--|--B-EBTEM|-M-M-Mo----o----E----X-M-|-X------?T-
---T-|o---oX-X----?-----MEM-----------XEo--|-----B-|?MM--TM|--ooE|-B-oX---------|EMBoo--M-XM--M|--T|-----?-----X--TTM------o------ToX-|-oo-M|XX---ET---XT?-----|-M----E--E--T-B--B?M---T-||--Eo---|?-|E-
--T|-T-T------M-||---T---?-o-----oE---MEB---------?------X----?E---??B-BEB-?---M----|To-E-------B--E-E--ToTXBT|-E---EX-T|EMTM-M-?M--M----o|BEB-M--o---E----X--B---|---T-X-----|-X-B--?-?-?--BM?|T-------
-M-E-o--M----oE-----M?-Mo-MB-----T--M----|----o------|---oMM-|---o?---B-o--|E-M-E----|-|M----|-X-o------o--M--|M---o--MM------o-X---M-?E------M|-|-M----?-X---B-------o--oo?BToB?X-----T-o-o-T-E-B-o--|-
--T--o||-EM--X-X?|--X-----|?Mo-|BT-ET-oX-E--?|-?MoB-BX----|-----|-|--------M-oB-|---o-T|M--?----XMM-E--M----M-|BT----E--|----M-|?-BMo--M--|o--??---M---X-|----B--|E-T--MX----M-X?----M-EEX-EMXE-B-?T-XB-
---TT|-?M-T-TE------XX-----oE-B|-MM-B-X-TM--ToX|------BTEM|-E|-?BoM-----|-T-T---ME---E?M-o----E---XTT--MXB||--TB|?B--B?-X---X|T----M-o--TM--M-|---B|T---TM----M--------oM--MX|X|M-T--T-------BM-Eo|BTB-v
---E---E-------E-?---X--M-T-?EEoo-X---?-o|?---E|T--METBT-B---B?MTB|----XoEX---|---B--T--?---BB---?M-?o---MT----?---?MM-o-MoT--EoT-E--?oBE---|---E--M|M---E-o-----B--MM---T----MM|T-o--XT?--oT-----M-TXTf
-XM------?-BM-B------E---T-E-EM--X-MMX-----?X----M-BXoMBEE?-BT-T-E-TEB--B----B---X--E----T|-oE|-MM--T---?------|---T?M----o--?X--X-oE---B---M-----X--M-----?M---|--|M-|ToX-X---ME-oE----M---oM--B|-?E-Mf
-o??-T-o-?B---o-X-X?-E--o-EXXB-oM-----X--|M-T---M|T-|E?---|MM?--Mo-To-XTX-|---?---o--E-?-|---?MX--B-X-o?-??-----------T--EBM---E-----MM--?-B-------M-M---T-M-o-M|--|----|-o---B-E-oB-B-----o----?--o--|f
-B-|o-E?-X-----B---M?----?----|---T--|---B-TM--TT---T---M--------B--E-o--o--M-B--E-M-E?-M-BXMo?|---|--|?B-oB-M|T-E---?--|----oE---M--B-MET-?-E|o-M--T-E---XMXM--?X-X--|o--BE-o-M---?--T-----B-E---XMM|Tf
---?--o------oo-MT-Mo----B|X---oMBBTMT?--EBT-X-----||?--MB----X--B----TB-X-M---MB?|M|--o-T--Eo--E----?-?-TEo--------E-o|---?--E--?E--|B-E-TB?M---E--|--|---E-M-|-BoX-M-oEM--------E--|-X--|-E|E-E--XEBXf
-ETB------BE--T---XE|M-Bo-M--------M?To---oTE--BM-o----o--o---X---|---Bo-B-||XM|-----X----?----XE??B---M-?-BX-?M-oT----o-E-?TT-ETB|-XB-T-----|B--o--ET-M--T---BX--XBM-|T-|--XX?---EEo-TM----X---MX----Mf
m---MT----o-MBT?T-X----E||?X|MM?X?-EM---??-o|-M-T--M--EX-oE----oBMTE-To--?---|-M--M-B--XoBEB|-M-X?-T-M--M-o|MX-?---M?o--T----X--o---EX--B-----B--EB?--T-o---|--B--M--E-T--M----EooM--M|E----o-T-|----?TX
XXXXXXXXXXXXXXXXXXXXXXXXXXXXXXXXXXXXXXXXXXXXXXXXXXXXXXXXXXXXXXXXXXXXXXXXXXXXXXXXXXXXXXXXXXXXXXXXXXXXXXXXXXXXXXXXXXXXXXXXXXXXXXXXXXXXXXXXXXXXXXXXXXXXXXXXXXXXXXXXXXXXXXXXXXXXXXXXXXXXXXXXXXXXXXXXXXXXXXXX
