-----------------o----------------------X---------------------------------------------------------------------------------------------------------------------------------------------------------------
-----------------------------------------B---------------------------------------------------------------?----------------------------------------------------------------------------------------------
----------------------------------------------------------------------------------------------------------------------------------------------------------X------------------B--------------------------
--------------------------------------------------------------------------------------------------------------------------------------------------------------------------------------------------------
---------------------------------------------------------------------------------------------------------?-----oX----------------------------------------------------------------------X----------------
-------------------------------------------------------------------------------???????-------------------------XX--------------X------------------------------------------------------------------------
----------------------------------------------------------------------X-----------o---------------------------XXX-?-------------------------------------------------------------------------------------
-------------------M----------------------M--------------------------XX------------B-------------------------XXXX--------------------------------------------------------------------------------------v
-----------------------------?--------------------------------------XXX------?------------------------------XXXXX----------X-------------------------------?------------------------?------------------f
-------------------------------------------------------------------XXXX------------------------------------XXXXXX---------XX---------------------------------------------------------------------------f
------------------------------------------------------------------XXXXX----XXXXX--------------------------XXXXXXX--------XXX---------------------------------------------------------------------------f
------------------------------------------------------X----------XXXXXX----------------------------------XXXXXXXX-------XXXX------------------------------------------T--------------------------------f
---------T--------------------XXXXXX----------------------------XXXXXXX---------------------------------XXXXXXXXX------XXXXX--------------B-----X---------------------|--------------------------------f
---------|-----------------------------------------------------XXXXXXXX-------------------M---M--------XXXXXXXXXX-----XXXXXX-----------X--------XX--------------------|--------------------------------f
m--------|---------------------X--------------------E---------XXXXXXXXX-----E-------------------------XXXXXXXXXXX----XXXXXXX-----------XX-------XXX--E----------------|----E-----E---------------------X
X----XXXX|XXXXXXXXXXXXXXXXXXXXXXXXXXXXXXXXXXXXXXXXXXXXX------XXXXXXXXXXXXXXXXXXXXXXXXXXXXXXXXXXXXXXXXXXXXXXXXXXXXXXXXXXXXXXXXXXXX----XXXXXXXXXXXXXXXXXXXXXXXXXXXXXXXXX|XXXXXXXXXXXXXXXXXXXXXXXXXXXXXXXXX
