-X--o-M---------X-M----------------o------oB--------------EB-----------B---------|-?E------------------o-T---------TM----------------EX--------|----E----o---X--------T-T----------E---M---T---|--------
----|-MX-----XE----oo--|--o-EM-----------B|----------EB---T-----M-|-T--T-----X-o-|--Eo-----M-------|--E--------------T---------E-----M--oo-M----------E--oE--E--|----------------------oM------XEMo-X-T-
-----|-----E-----M----B--------X------X-----------------|---T-----M---------------------|-----o--------------------E---|----E-----T-|-X-?----------B---------|---------B--------|---M----XM-------------
--|--o---B-o----??E-Mo---------------E-------M---E--oM--TT---------------------|?-?||Bo----|-----M-----T---o?-M-o-------M|----|-----o---?-----M---------oE-----------------|-M-M--o--|-B-o---|-|--E-----
--o----X---?--E------?o----MX-TM-------T--M---M-----o---M------T--o---E------o-------??B----E---------?X--------T-Eo-E----B---------E------?-MXMBE-E---T-------EoX--|-------X|--T-M--B----------------T-
-XM-----B---X-EB------?-B--|-o-o---------?-------T-|M?-----------|-?o-E--M---?------o-T---?-------E-----T-|-----------o|--X|-------o--B---?T---XXME-T--X---BT-?B---T---------|-?-------------ME----T-B--
------X----B----E---X--E----TMX?----M-------B------B-------E--E--B---------------------T----------?---|TE--Mo-----o------------B-o--?-oo-?-----M---M----B-------TB------X---B----T---o-------|M---------
--E----o-M-----------o---------E---------o------|E----M-----M----------E---------M--E-----|---E-----B--------E-----TT--M----------M-----o-----?----B-B--?---E-------?--EE---o-----o?----X-?----B-------v
-------o-o----------------------|---EX|-XM-XT-------E--T--------|o------------X-----o??------------|--?T-|-----T-X--------E------------|---o----?M--E---X----o---------|--------------|--------------|-f
-T-E------?EX-M------------------------o?-----|---M-----o-|-?----Xo------------BBTB------M-?B--------------B--|--------o----B-M--MMo----XB-|-X?----o----X--Mo---ME--------oE--To-T-|M---?----XM-?------f
----E--?T-ME---T-------?------B-M---M---B-E-----T--?--o--------o-M----E---M-M--X-----oXo--|-----o--E---Eo?B---------M-o-----------MoTX--?--|T-T----E----o--------T-------o-----B-----T-X-|------------?f
-M-E---|--------T-------X-X---X-------B------o------E-X---E-o--M----------|---------oMX-TTX-----------T-B--E-----------------------------|--------o-o-------------|---EEMB-----------------X--B--?-|---f
--B------X---o-X---------------------------oB--M------E----------E----?----------|---------X---MB-E----------T-----o----?B--?---|E-T-------B-----M----o-o--|--------||---T------M-|-------B-?o|--------f
-E--B-------|--EE--BX-----T---|E---o------X-o-----To--------------|-E--------------|o--|--------B-------------T------E--X?--------B------B-X--|-----?-----|---E-------------B---M?o-B--TX-BoT--B-----M-f
m-----------------T---o--X-----o?------o--B-?------------o-------|---XE-?-?-|-----B--E|-----X--------------------M---B--|-----X-o---E?----||B--------------XXo--T--------X--------------|--B-o-|-M-To--X
XXXXXXXXXXXXXXXXXXXXXXXXXXXXXXXXXXXXXXXXXXXXXXXXXXXXXXXXXXXXXXXXXXXXXXXXXXXXXXXXXXXXXXXXXXXXXXXXXXXXXXXXXXXXXXXXXXXXXXXXXXXXXXXXXXXXXXXXXXXXXXXXXXXXXXXXXXXXXXXXXXXXXXXXXXXXXXXXXXXXXXXXXXXXXXXXXXXXXXXX
