--------------------------------------------------------------------------------------------------------------------------------------------------------------------------------------------------------
--------------------------------------------------------------------------------------------------------------------------------------------------------------------------------------------------------
-----------------------------------------------------------------B--------------------------------------------------------------------------------X-----------------------------------------------------
------B--------------------------------------------------------------------------------------------------------------------------------------------------------------B----------------------------------
----------------------------------------------------------------------------------------------------------------------------X-----------X---------------------------------------------------------------
---------------------------------------------------------------------------------------------------------------------------XX----------XX--------------------------X------------------------------------
--------------------------------------------------------------------------------------------------------------------------XXX---------XXX-------------------------XX------------------------------------
-------------------------------------------------------------------------------------------------------------------------XXXX--------XXXX------------------------XXX-----------------------------------v
-----------------------XXXXXX-------------------------------------------------------------------------------------------XXXXX-------XXXXX-----------------------XXXX-----------------------------------f
------------------------------------------------------------------------X----------------------------------------------XXXXXX------XXXXXX----------------------XXXXX-----------------------------------f
-----------------------------------------------------------------------XX---------------------------------------------XXXXXXX-----XXXXXXX---------------------XXXXXX-----------------------------------f
----------------------------------------------------------------------XXX--------------------------------------------XXXXXXXX----XXXXXXXX--------------------XXXXXXX-----------------------------------f
---------------------------------------------------------------------XXXX-------------------------T-----------------XXXXXXXXX---XXXXXXXXX-------------------XXXXXXXX-----------------------------------f
-----------------------o--------------------------------------------XXXXX-------------------------|----------------XXXXXXXXXX--XXXXXXXXXX------------------XXXXXXXXX-----------------------------------f
m------------------------------------------------------------------XXXXXX-------------------------|---------------XXXXXXXXXXX-XXXXXXXXXXX-----------------XXXXXXXXXX-----------------------------------X
XXXXX-------XXXXXXXXXXXXXXXXXXXXXXXXXXXXXXXXXXXXXXXXXXXXXXXXoXXXXXXXXXXXXXXXXXXXXXXXXXXXXXXXXXXXXX|XXX-XXXXXXXXXXXXXXXXXXXXXXXXXXXXXXXXXX-XXXXXXXXXXXXXXXXXXXXXXXXXXXXXXXXXXXXXXXXXXXXXXXXXXXXXXXX-XXXXX
