--------------------------------------------------------------------------------------------------------------------------------------------------------------------------------------------------------
--------------------------------------------------------------------------------------------------------------------------------------------------------------------------------------------------------
--------------------------------------------------------------------------------------------------------------------------------------------------------------------------------------------------------
---------------------------------------------------------------------------------------------------------------------------------------------------------------------B----------------------------------
----------------------------------------------------------------------------------------------------------------------------X---------------------------------------------------------------------------
------------------------------------------------------------------X--------------------------------------------------------XX--------------------------------------X------------------------------------
-----------------------------------------------------------------XX-------------------------------------------------------XXX-------------------------------------XX------------------------------------
----------------------------------------------------------------XXX------------------------------------------------------XXXX------------------------------------XXX-----------------------------------v
---------------------------------------------------------------XXXX-----------------------------------------------------XXXXX-----------------------------------XXXX-----------------------------------f
---------------------------------------------X----------------XXXXX----------------------------------------------------XXXXXX----------------------------------XXXXX-----------------------------------f
--------------------------------------------XX---------------XXXXXX---------------------------------------------------XXXXXXX---------------------------------XXXXXX--------------o--------------------f
-------------------------------------------XXX--------------XXXXXXX--------------------------------------------------XXXXXXXX--------------------------------XXXXXXX-----------------------------------f
------------------------------------------XXXX-------------XXXXXXXX-------------------------------T-----------------XXXXXXXXX-------------------------------XXXXXXXX-----------------------------------f
-----------------------------------------XXXXX------------XXXXXXXXX-------------------------------|----------------XXXXXXXXXX------------------------------XXXXXXXXX-----------------------------------f
m---------------------------------------XXXXXX-----------XXXXXXXXXX-------------------------------|---------------XXXXXXXXXXX-----------------------------XXXXXXXXXX-----------E-----------------------X
XXXXXXXXXXXXXXXXXXXXXXXXXXXXXXXXXXXXXXXXXXXXXXXXXXXXXXXXXXXXXXXXXXXXXXXXXXXXXXXXXXXXXXXXXXXXXXXXXX|XXXXXXXXXXXXXXXXXXXXXXXXXXXXXXXXXXBXXXXXXXXXXXXXXXXXXXXXXXXXXXXXXXXXXXXXXXXXXXXXXXXXXXXXXXXXXXXXXXXXX
