----E?--?----M-?---BX-M-XEM-M--B-E--X-|--M--TT-oT-----------B?----MBoo-----|---?---E--B--o---XE-E-?-?|X?-X--E|--oBE----XMT----|-o---T--MXEX---------o?-M-MB------E---E----?XB-B-----XMB-|--Eo?-??---o---
--o--Eo-o-----|o?---|--|--XB-XM--X|-T--X--|--X--o--?---|--B----E?--X?-M--o|----M-T|Bo-?----B--B---E--?M---T-?E--T---E--B-|E---E--MB--oM----B-o------E-oB------o?--M-EXE-M---?---------X--?---E--EM--|-E-
-E--MB-BX?-E----?---oE-???--B-X?X---E----B--EB-BBE-o-E-EM---Eo----E-X---TXT---X?-|-B---|-?BEX---MT-T--X--o-oo?E-?--B-B-E?o--X--E---oo|-B--EM------T--?-----B-o-T|?T-M-M--o----o----E--|MX|M---T----|-?o-
---T-|o-X-oX----------M---M-o|--EB-|----o--|-----BE-?|X---M|--oME-Mo-o---TX---B-|-ME-------Mo--|--T|-----E----XXo?TMo--E---------ET-XB--o---|XX----------?-----o|M--M------oTTB--B?M-----|----o---|--|E-
-T?|-T--------M-|XM-|------oX----oE-|----M-BM----??M-----?-----E-T-??BBB-B-?--?-----|---E--?-|-?|-T-----ToMX--|-----E-?--E-?--M|?M--M-|--o|---TM--M---E---MB--BX---oo-T-Xo----|------?------BM?o?M--B---
---E----M-M--XE?-----oBMo-MB-o---T----E--|-T--o-Mo---BM-?o--------?---B-E-E|--M--B-M---BM--Eo|-M---o?---o?-Mo--MM--o-M-M-----Mo-X---?-?---EB--M|-|EMX----BX-------?---o--???o-oB-X-X--X?oo---T-----o--|-
--?--o---E---o---|--X-X|-EB-Mo-|-To|B-oXT----|-?MoB-B|----------|M|------B-M-oB----T--E|MM--T---XMM-BM-MM-----|BT----E-?|-o-MM--?-B-B-XM-o|oB-o-----M--|-T-|?----|--X|--X---TX-??X---M--?--E--E|B--T----
----T?--X----E---E-B-X---o----|------M-|oMM-T--|--BTT-oTEM-B---?-oMX---|||T------E---E?X-o----E---XTo--MX-|-----XEB--B-o--o-X|BM---MX--E-M---B|-|---?o--TM-----o-----------M-|-?M-T-?T------?-M-Eo|BTB-v
----T-----oX--M?-?--B---M--oXEE-o--M----o-?-o-X|TT-|E|BX-X---B-M-B|----XME-?----X-B-TT--?-E------?--?----MT-----Bo-?M-BoTMoM-MEE-----?oB-EX-|--B-X-M|M---?-o-o---??-E--E-X--TM|M-ToB-EX?-TToTX-----M-XTf
--M?-----M--M-B---B--E--MTT---X--X-MMX--T--?XT----?oMM-|EE?-B-XT---TBXX--------EBX-TBM-E--|---|-MM-E--------X--|---T?X-------?X------o--B--E---T--X-?M-----?--------T-MT--XX-E----oE---------X----E-E-Tf
-?E?--M--?B-X----B??----o--XX|-MM--B--X---E---M-M-T--E?---|M--TMTBE|--XT--|-M-?---o----|-|---?Mo?-B-B-oBB?-T------MM-----TX?M-EE--T--o-M---B--o---XM-M-------ooo|-------|-o---?-E-oB-B----??E---?---B-|f
-oM---X?-X--E-----?o-----?---E--|----|----MTX--ET---X---M--o---------XoE-o-?M----?BM-BT-?-BXMM---o-|--o?--EM-M-T--|--?M-|----oEB-?M-BB-M-T-?-EEo-M-o-------M-M--??-----X--BE----B-X?E-----T-E-E------|Tf
--X?--o-|-?--o-MT--Mo----B|----o--B-MX?-EE-T-X-----||--|MB----X--BM-?-TB---X---MB--M?-ET-T--X---E------?-TE|-X----T-E-o|-o-?--TE-?E--|X|--TB?M-?EE--||-----E-M-o-T-o-M-oE------X-ME--|?-----E|-----XEB-f
-o-B---E--B---T--EXE|--BoM-T---|X-?M|To---oTE---M------o|Bo-M|---o|---B-?----XMM---------?BT---XEo?---o--?-BX-?M-MT----o---?TT-ETo-----o--B--|-T-E--?T-M--T---B?-XXBM--B-|--T-?-?-E--|B-o---?-E-B----EMf
m----E-?--o-BB--T-o-E--X|?---M?-B?-EM-------MXM----M---X--E--T-o-M?E-To------|-?-BM-T---|BE-|M-?X---?M--o-o|M-M-|--M?o-------X-X-?---XM---?---X-ME-T|-T-o---o-XMXEM--E-T--M?------Mo-M|E---To--M---BE?TX
XXXXXXXXXXXXXXXXXXXXXXXXXXXXXXXXXXXXXXXXXXXXXXXXXXXXXXXXXXXXXXXXXXXXXXXXXXXXXXXXXXXXXXXXXXXXXXXXXXXXXXXXXXXXXXXXXXXXXXXXXXXXXXXXXXXXXXXXXXXXXXXXXXXXXXXXXXXXXXXXXXXXXXXXXXXXXXXXXXXXXXXXXXXXXXXXXXXXXXXX
