------EXT-|---M-----X-M--B---EB---|M----Xo---X-o---M---?MX--T-?-TXM----TX-ooEM-?-|EX-BoMX-?--|-----E?--?-T--M---TB--X--MM-o-MX--o---T---M-T----M-TB-o-|--X--o?M-|---T----M------T---?M-?|-EET?-----oE---
----??o?o--oMX-|B--BX-M-o-MB--TMM----BX?|-|oMo----oE---E?--Bo---o-M---ME-o-E-BMMT--Bo--|-Mo--M-|-----?--?ET--EBE-?|---|---EM-|--|-?---M-B-oB---|--T-B-o--T--Eo-M?-E--|?----M?-XE-E-E--|X--|-T--|--TMT---
-E-X--T?XEX-?----|--?--?E-To--------------EX?--M|TTo-------XEoo---|TXB--M-T--M---|-Mo?oX|X--??----XM---oB----|T--T-B-E--?----MM----E---X-XBM-E--EE-E-?X--E-B---E|MT--o---oTBM-EXTT-EBX|MEM--------?-----
-|-T-oX-X---?XEE-M-----o-M|---?M-Bo||-E-o--|----Xo-??MM-E--|--oB--Mo-?o---?-??-||--E?---M-?--T---?-|--BT-oXE|-EBoM-M--ME---B----B-----|--X--------MTM---T-X-o-ToMMM-X-E?-|----------|-M--||X-X-M---EM---
--?M----------MB|?---||-M?Bo-E-|E--oX-ME|---M-MTXo---|-----|--?o--E---BB-B-B-----E-M-X----oT--MXo|MT-E---o-BE----?|o-|--MX-----|X---------|BE---E-M---E-?-MXB--X---MM-T---?E-X------M-oB----M-?T?M--B---
--EE--|?ME----??---|--?MB----?|-E----------?X?-?|o---|M-?|MM-|---o----?TE-E--M-?|M-B--||M??E-?----X-----E----B-M-E--B---------o---|-?X?ooTEE-M--BE-MX?o-?--------o----|-Mo-?--E?----T-T?-M-o-TE-oB?|----
-BT?-o----M----X-|-o-B-o-EB-------oTT-M-|-----E-B-B----E-|-X?B---MB-X-E?-B-MoTBX--M-T-X-M---MM-EXMEE--?-M?---TXBMT--T-|-|---M?T-?-BMo-BMX-BT----XB|--ME--?-|-?---|-EX-MM-----XoX?oT-X---|XE-?-M---------
-E?M--o----|XE--------|o---oMX--M--|----o-MB--X---|---oBE------?B?---M?---?-----?-TX-EE--E--M-E----TT--?-TT-----|EB--B?--oo-M---|E------MMM---MB--B---?-TMX--X-oE----o----T-E|-|--T-|T|o--T---------T--v
---E--TE-ToXo-?----ET-E-Mo-o-EE--B-|-M-Mo-----E-----B|--|------X--|-E---o-T---o--o--T---To?--B-------o---|-?TX--BME?XE-oXMoM-TEE--X--To-o-?--E?----X---XoE-o?-------E--T--|-TT?-------B?---o--B--------f
--M-o-MMM-E--|-M---|BMB----Eo-M-EoE-o--M--o------|o---M|E-?T--EM-E-?---------B-E-X-EE--T--|----|--|-T---M----M--o--T-MT--||M-?---T-E--?-----B--?-----M---B?-T--E---E?-|---------X------X-M--o-T-T-X-|--f
--E--XM---B-oEo----E|E------ME-----|------B--?----TE?-?-?-----oMMBX-o?--X--|o-?-TEoo---X-o----M----|X---M?--T---E---EX---------E-X--X---T--ME-E|T--|-----T-----M-M--BTBXE-----BM---E-----XB--T|-?-----|f
-EMTo-TMo------M--TMTB---M-M-EE--|-o|||X?oo--M--To-BTEBT------|---|---oE---TM-B--?---BE-?-|-MM?BBX|||-|o-|-E----|-M--T|XX--E------MTT--M|-B?-EM--M----E----M-MT-BT|X---X-ooEM-B-X-To--T--TT----------EBf
-M-----E-o?--o-BM-----B--o-X|--o---?M--B-E--?-TM---|-?E-----X-|T----?----X------M?XB---TE-----BBBT------E--|EE---o|-B----o-?-TTE-??-TMBMM---?---Eo---BB---|Xo-E--MT-T-?-TM---T?X--T-------oo----o|---B-f
-E----TXX-----TT------?B----Eo?-MX-M?To--------B-?o---|--To----B-|-B--B--|--EXT------|M---?T----E?-E-E-E-?--BM---EE-o----?--E--XE--MXE?T--?----B-o--BT-M--?--?-?TBXXX--Bo-o?B-?BT---T---??-------X-B|-?f
mT-X------?--BT?-MX---T--o?--M?--E-EMX-X-|--M-MB---?--|Mo-o-ET--BM?EMX-|-?---?---oB-B|-X-E-B---MB?---ME-ME-|M|---EB--M--E----T?--T|X---|M--|--X-EE-T-|T--oo---X--EM|-o---BMTE?MoE-E-To|-XX--B--|-o-B---X
XXXXXXXXXXXXXXXXXXXXXXXXXXXXXXXXXXXXXXXXXXXXXXXXXXXXXXXXXXXXXXXXXXXXXXXXXXXXXXXXXXXXXXXXXXXXXXXXXXXXXXXXXXXXXXXXXXXXXXXXXXXXXXXXXXXXXXXXXXXXXXXXXXXXXXXXXXXXXXXXXXXXXXXXXXXXXXXXXXXXXXXXXXXXXXXXXXXXXXXX
