-?----XM--oMT--oT-E--T-B-----------?--B--o--E--------E----T-E------|X---oM------o-------------------M----B---------E-o------o-oX-?------B-----|--B----MB-------X------E----o?---M-E--B---?-----M--------
--------o---E------oo------------|E--B-?------Eo-B-oX-X--E------B--------|--oX-------------|-------------B---?---?--B---------------------------------T----?---o-o|-o-------X-------M-M----E-T|---------
---?-EX----|E---------X-------B-M---o-|--B------|o-------B------TT--E--B--|B---X----o------T----|---E?B------E-----------M--M--X---------?--------?-B--?--M--o---E-M--M---X------E----------X-----E-----
--X-B----M----?BoB--------------T---X--?----E--T---?--XoB---------M---?E-E-X|--------EM--T--XX-o-X?---------o----o--o--------------o--T----TE----?-X---X--------E---------X?---------?oB-E-----T---o----
------------X---o----MT-o----ME----M-----o---o--|E------?-------------?-----M---X-----------------?o-EM--oX-TM--X----------X---MX-M-M----M-----oE---XB-E--X-|---o-E----M-?o----M----X---|--------|---B--
---X----------------|E-----Bo-E-----|?M--?----o--M-X------?----BBE-T-----o--X-----??-oB-T----M--o--|--?M-------M--------E?--TX-----EM-----?|---?---E-----B----o---B---ET---?-E---------?------|?--?-B-o-
-E-B?-?--Xo?----B----M--T---------o?-----o---M-B--B------B---X-E------X----------B-o--o-M------EBB-------TMB-------|---|-------?----B---E-?-T--?----Xo|----?--B-----B-E?-M-E--T|------X----M-B-B-M-M----
-o--E--B|-M--o|----|X----E--E----o-T--?-------------T------------?E---Mo?---X---T-----o------E--M-|--B-X---B----B--B-T-o-B--X-?EM----B------------E|---B-MM-|B---|B-?----X-M-X---B--||---E----?--------v
--M----MM---B-----|ME----------oT---oX-----|-------o--?------?---oM--o----------M-?oE?----|----E----|X----X--M-----------B----o-------E-E--E---------E---------X-E----|oE-o--|T|-------------X-----XoXEf
---?------BXMX-------M--B--o-o--------------?---oo-BX--------------X-------?|--T--------?------MX-o-E?-?|--B---XE-T--------o-B---M-----B-?--M------ME----------EX?-M--?--M-----|T|M-oo---B-E-----oE-?--f
-o-E-?-----------------?--------M-------E?--o---M--?E----E-o?--E--T|MT-?-E-o------B----?---?-E-B------T-----BXT----M------o---|--M-BEB----?-E-------B-oM---T--E---B-M-----B------X---E----E--T----o----f
--T------?B-o|o---X-M---?-M------o----|M--?-------------oo---|----X---------X--EX----------------B------EBT--M-o---T|--B-B---o--X--EX----o-------?--------------E--oXT?-E----MT-X----EM--B---X----B-X-|f
---------E------o--?--M-BXE-X-o----M--M---------?---M|-|----EX---E-E------XT-XT-M-----M---------M-E---o-B----?--E-----B----E-Eo---MM--E-----------X-E----B--------------------T-----?|--?-o-o---|------f
-BE------M-T---------M---|---------Eo----------X----------T-------B|-|-----E--ooBo-X--?M------o---------XM-------T-BM-o----?MX-------X-----??---------E-B-M?--X--X---------X---BX-------------BM-----o?f
mX-----M---|-o-X---B-T------B-------------BXEMo----oM-?M|--|---BE---o--B-B?--------XB-o-----B-o--M----o--o---ooX--oE---o----X--o-X-----M---E---o--------T-------X----X-Mo-|--M----|---EB-?----EX|---?-|X
XXXXXXXXXXXXXXXXXXXX-XXXooXXXXXXXXXXXXXXX|XXE-XX?XXXXXXXXXXEXoXXMXXXXMXX|XXXXXXXT?EXX-XXXXE?XXXX?XoXXXXXXXXXXXXXXXXXX?-XX-XXXXMM?MXXX-oB-BXXXX?XXXBXXXXXXXTXXMXXX-X|XXoXTXX-XBXXXXMXXEX-EX|XXXXXXXXEX-XX
