----E--o?----oX-X--------M--------BoT|----E--M--B--X-XM|-----o----M--------Mo-------M-----o----------X----------M------o----B---?-----?--E----X?-------?-M-EB----X-X-----o-----BME--------oM---o--------
-B--|--o-------T-----X----|--M-----|----o------------o-----------T------?-----M----X------E|o-M-M------------------M-------B--o----X------------?-M---oM-------|-----X-?----|---T-----------------------
-X--T-----B-----o?---------------------------o?-|T--------|-------X---T---------?----B---MXXX---M-o--------E-o---XM-B---B|--X-----E-----?---?--X------o------------X--oo-----B-T-----B----------To------
---?--------|----Bo---X|---|----------?---X---B-----------XM------?---------B----B----M-T----B------BoTM---M--?---|-MT--------B-B----------B---------o--B---------XE------oo-?--------------E--------BM-
-X--?-ME------|-?-------------M------MX---X--oBB---------M--M--MTME--M-----------------------------M-X------o----B------M----X-o|TXo--------T--B-T-----X---T?------|-E--?-o-X------?----T-?--ME---------
------o---M-----X--M?----?--|-----------oE-------o-E----------TM-XE-----------B-----oM-----T------------?--|-------------X-M---------?M----X-o-o?-|------|---X----------?--o------|----------oX----o----
-E-B--?--X-??-B-----M----B------E---B---------M-X----T-----------T|-?-----B----------------T-?-|--o-------X-EB?T-E---E-M----------B-|-------E------M--B--?--T---M----M-------------------E------|-------
----ME-?----E-----?-?E-----M-----------------o------|------------T----------M-----M-----------BM---oE-------------EE-oX-----M------?-----To----?-----o-----?----E--E----T-B-|-X---EE-o-------M-|-------v
-?-----?----T-------M-T------X-B------------B--o----E-----E------------B-------M--|--------?--?X------------B---T?B|-M---?-------M-?oEM---o-BE-------M--|-------------E----E-----------M-----?X-------?f
--B--XM--------------?-----B----|EE---------E--?-----EX?-M-B-MT------------B------XE--------------------B------?M-----E---------X--?-------Mo----To--M------?o---?o--E--M----?E----------------------o-f
--M-----T------E------------o--------E----------------??T----X---|----------X--o-M-----B--------T----ToM--E-E------o------B--??---E--X-----------M?M--o?-----B--?M--M-E--oo-------E--------|X-B--------f
---------Eo---oo-----o---M--XB-----E----E-|--M--o-E-----B-------BE-----------M--?------?--?EX--------------B-------M-E----------|-M----------?-?---------?-BBX-----E--M--B--o-----o-------XB-----------f
--E--------------?--E-----X-X--B-X----T--------M-------o---------?--------------------------BB-T?------T-X--|--?-----------XX--E-M----|----Eo------------|--------------M--oX--X----------M--o----T--B-f
----X-------T---------------|-----------B---------E-----------M-----------B-o----|-------|-?-----?----------T--------o?-------M----M---?--E--?------------B---X-|-------E---M----------B---BE-------X--f
m--B---?---X--X-----T?------B-----------E-----T--B----------|-X------o--o--o-------------M--M---ME---------B---X---M---------?----------------T-----X-------Mo-oX-X---o?T----B-----E--o---------T------X
XMXXXXXXXBXX-XXXXBXTXXXXXX?MXXXXXXXBXXXXXXXXME-XXMXXXBXXMXXXXXXXEXXXXXXXXXXXXXXXXXX-XTXXXXXMXXXTXXXXXXoXXXXXXXXoXXB|XXXXXXXXX?XXXXXXoXXX?XXEXXXXXXMXXXEXMXXXXTXXX-XXXXXXXXEoXX|XXXXXXXXXX---ooXEXTXX?o-X
