---------------------------X----------------------------------------------------------------------------------------------------------------------------------------------------------------------------
--------------------------------------------------------------------------------------------------------------------------------------------------------------------------------------------------------
--------------------------------------------------------------------------------------------------------------------------------------------------------------------------------------------------------
---------------------------------------------------------------------------------------------------------------------------------------------------------------------B----------------------------------
----------------------------------------------------------------------------------------------------------------------------X---------------------------------------------------------------------------
------------------------------------------------------------------X--------------------------------------------------------XX--------------------------------------X------------------------------------
-----------------------------------------------------------------XX------------------------------------------------X------XXX-------------------------------------XX------------------------------------
---B------------------------------------------------------------XXX-----------------------------------------------XX-----XXXX------------------------------------XXX-----------------------------------v
---------------------------------------------------------------XXXX----------------------------------------------XXX----XXXXX-----------------------------------XXXX-----------------------------------f
--------------------------------------------------------------XXXXX---------------------------------------------XXXX---XXXXXX----------------------------------XXXXX-----------------------------------f
-------------------------------------------------------------XXXXXX--------------------------------------------XXXXX--XXXXXXX---------------------------------XXXXXX-----------------------------------f
-----------------------------------------------------------oXXXXXXX-------------------------------------------XXXXXX-XXXXXXXX--------------------------------XXXXXXX-----------------------------------f
----------?------------------------------------------------XXXXXXXX-------------------------------T----------XXXXXXXXXXXXXXXX-------------------------------XXXXXXXX-----------------------------------f
----------------------o-?---------------------------------XXXXXXXXX-------------------------------|---------XXXXXXXXXXXXXXXXX------------------------------XXXXXXXXX-----------------------------------f
m---------------------------------------------E----------XXXXXXXXXX-------------------------------|--------XXXXXXXXXXXXXXXXXX-----------------------------XXXXXXXXXX-----------------------------------X
XXXXXXXXXXXXXXX---XXXXXXXXXXXXXXXXXXXXXXXXXXXXXXXXXXXXXXXXXXXXXXXXXXXXXXXXXXXXXXXXXXXXXXXXXXXXXXXX|XXXXXXXXXXXXXXXXXXXXXXXXXXXXXXX--------XXXXXXXXXXXXXXXXXXXXXXXXXXXXXXXXXXXXXXXXXXXXXXXXXXXXXXXXXXXXXX
