-----B--------M-B--oXM--XE--------|ME----M--TT|-T-----E-|XE-B---o-MBo---X-E|-M-?T-EE--o?--ME--E---?-------o-E|-?XB------MTo--B|B-|--TToMB-X-----o--B---MM--M----Xo--BEX-X-?-X---T---M-B-|--Eo?--?-------
---X?E--o----X|-B--B-oX|---B-XM-E-X-T--X--|--X-Xo--?---E--------|-TX-o-E-o---o-M-T|B-X-X-To---B-------M-------?-T-?o---B-ME-------?-MB-----BX-------B-?B---X--o-E-M|E---?---?-----T-------|M-E|---TX--B-
---XMB--X?-E--------oo--?-X-T-XT---|E----E--E--B---o|E-|-XM-Eo----E----T-XT---X?M|-X--B|-EBE-X|M--oT?-Xo---oo?E-?--BEXME-EMMX--ET--o---BM-BM--?oM-T-X?--|-EB-oBM|MTX--M-M--B-Eo----T--|--MM---T------?o-
------o---o----?-----E----M-o|BX-B-|-MXEo-X?-----BE|-MX--TM|---oE|-B-oX---X---B-|EM-oo----X-o-M|--T|oX---?-----ooMTMM------o-----ET-X---oo-MM--B--ETM--XTB-----||-----E?-|--T-------E--T--|--EoM--|?-|B-
-TT|-T-----E--E-|X--|T-----o------E-|---BM---------------?----?----??X-BE-----?--E---------??---B--E--B-ToM--T|-E?-oE|--|EMTM-M-?-|-M-|-TM|-EoXM--M---E----X------|M--T-XoX---EBX--------?--B-?oT----E--
-M------M----XE-----E?--X-MB-----T--M---X|----o-Mo-------oM-?|---o----E-E-E|E-M-E----|-BM--E-?-X-o------o-----|M---o--oM---o-M----X-M-?-o----B-|-|-MX?----X----X---------oo?o--E?X----XT-o-o-T-oXB-oE-|-
--T--o||-EM-EX-X-|--X-X--EB-Mo-|BToEB-oX----?||-MoB--X-|?---B---|-|---E?--oM-oB-X---o-E|--o-----XMM-EM?M----M-|B--|--E--|To--M-|--MMo-X--o|o--??---M---|-T--?XoT--EEX---X----M-X?----M--EXEEM?X-T-?TB---
-----?--M-T-TE---E---X-----oE-B|-M---MX|o-M-ToX|---TT-BT-M-B-T-?B-ME|---|-T-TX---E---X?M-o-----T-TX-T---XE-|-M--XE-EE----X--X-----oMX---TM--MB|--EB-To-|-M-E--M-----MM-oM----|-|T-T--T--------M-Eo|B-B-v
---E---E------ME-?---X--MB--?--oo-E---?-o||---EX---|E|---X---X?M-B|T---X-E----|---E-T---?--EBB-E--M-o-?--?-----?B--?--Bo-MoT--Eo--E--?-BE----?-BB--X-M---E--T----B--MM--|T|--MM|-T-o---T?--o----M---TXMf
-BM-----B?E-M-?------E---T-E-E---o-EM--MT--?X--T---BMoM|E??-?--T--|T-X--B--------E--B?-E--|--E|o-M------?------|--XT?M----o---X-B--oE-----E-E|-T--X----M---?--X-|---T-|M-X----?M--oE-------E-X?-B-E-E-Mf
--E?---o-?|B--o---X?-E-----XX|--M--E-BX--|E---M-M|T-ME-----M-?T--o-To-XT--?----X--o---X|-|T--BMo|XB-B-BB-T---|--?---B------M---E----|o--------o------M-o-MT--o-o-MT|----|-o---B-T--B-T-----?E---?--oB-|f
-BM|o-X-BX-------MTo-?-------E--|-T--||----TM--TT--ETT-EM-----------EXo--o-?M----E---E?MMTB-MM?|---|--|?B--B-MTT-E|--?--|---M----?M--B-MET-?-o|o-M--------XM-B--?X-T---X--B--o-MB-T?-T-M----E?ET-?EM-|Tf
--X?-------B---BM--Mo-|-EB-X--E?-BB-MX?--EBT-------|E----B--BBX--B-------X-M--T-B?|M|oEo-|--Xo--X---T-??-TEo--------E-o-oo-?--T---E--|EXE-T-?T--EE--|--|---E-----TTX-M--EM---T-X-ME-X|---M|-E|--E-|-XBXf
-ET?------BE-oT---XE|--To----?---X--?TX---oTET-B--o----o--o---X---|---B-?B--|XMMo----------T---XE??--|oM-?-EXEXM-M--?--o-E-?TT-E-BM-XB-T-----|---E--E-|---TM--B?-|-BM--B-|-XXT?---EEX-TM----X---MX----?f
m----E-?--o--BT-T-o----E|-?-|MM?o?-E--o-??--|X--T-EM--EM-oE--T-XBMTE-To--?---|?M--M-M---oXEB|-M-X?---M--M-o-MXM?---E-o--T---?--XB?--EXM------BB-EB-?--T-o---E-X-X-E--E-T---------BMo-M|E-X-T--To|---E?TX
XXXXXXXXXXXXXXXXXXXXXXXXXXXXXXXXXXXXXXXXXXXXXXXXXXXXXXXXXXXXXXXXXXXXXXXXXXXXXXXXXXXXXXXXXXXXXXXXXXXXXXXXXXXXXXXXXXXXXXXXXXXXXXXXXXXXXXXXXXXXXXXXXXXXXXXXXXXXXXXXXXXXXXXXXXXXXXXXXXXXXXXXXXXXXXXXXXXXXXXX
