--o-----E----XE--Bo|-------------X--Eo---X-X-|---Mo-M-EE---ME----X-o---BB------B---X---------M--MM--E--?------------M-oB-------------E-E---M---------?----------------?B-ME-E--oE-Mo---B?------------XE-
--Eoo------o--E-o---?-o?------------EB--E-------X-------X----o---T---X------------------B?---o------EE-M-M-MB---|--MXXB?----B----BX|-------B----E------oB--E-oM-Bo------M-----------X-T---E-E-------o---
--?----E-----X-M----?--E---------o-?--XE------o----------?--M--M-?--X--o-----o-X----E-------?----B-----|--------ET-X--o-----X--BB------E---E---M--o----?XM---------?o----------E-o-------T-M--------o---
--?X----------o-----|--?--------|XX--|?--B-----BE---------M--?-X-EBX------oo-M----------o?o?-M--X------X---oM---?E-o-----MB-------B------X------T---XX----------|-||B---------E-To--E--MX------E?oB-----
-----B?-Bo--BE----X----o---X------?--------E---X---B--?-----|--X--B-X-M-M-o-o-------EB--EB---B----M--E-M-M--B--X|o----B--------------------X?------B?-?---X----?-o--XB----X--E------B-------------B-----
---o--E-o-||oB------?B-B-------?------?-------M|-------o-|?--Eo-EX-o--X--M--------?------E-------o---M-E----B?E-E-B---X-T----B-X--E--o?---?E-M--o-----?--M---T-M-T?----------o-X---|-?-TE-------------T-
---B-T-------B?---BEo-----B--E---|----o---o-|-EB------EX-----M----XX-------------o---o-o---TX----BM-----M-XM-MX----B----o------?-----o---XM-B---?-oEMM-----T------B-|-|-o----|---B----BX---------B---oM-
------X-------------o----E--o---T----------o-X-|T?---------X?-E-?---o|-MB-----B--B--E-X---E|----MT-|----------------M----M---E-------E----------E----E---------T--?-X--E-------B---E-E-------------E---v
----BB-T-----|--?-----E---------|---T---XE----M---E-------E-M|-?------o-----|--o-BM---------B----|--X-o----To---B|--BX-----T--------o---X-------X-E-----Eo----B-?-|-------X-----M-M---M--M--------o-T--f
------|---|X-B---|B---M---------E---E-----?E------T---------X------X--E-----M|B---|---E-MT-E-?--E--M-o|---X--------BE-B-----E-B-T-|-X-XBM------EB-B-M?---M----X-?-o------o-X---M--?---E-E-|?---X--?--o-f
------TM---|-B--X?------|?E-o----E-------T-BE---BM-----?-EM----Eo-?--B---------|-----E-------E-------X--|o-----B---Xo-------BB--E-E--------|----T--o-MB---------B---------M-?B------E--E----|--------MXf
---X--|X-------o--B-X---E-M-M---|--o-?--M----------------o----------B-o-X--?---E-------E-------B-----------------B------------E--E--X--Xo--?------B--B-?EX-?-E-X--B--------XMMEX-----?-E--X------------f
----o--------MM---X?---E--B-Eo-|--------?T---M-B--B-o|-----X--------BM?-------------?----B-B--|--------T------oX--------EoX---|-o------------Eo---?-BT----M---------------o--------M---B?------------?-f
-o-|B-----oEB-------E--??-------B--B----?--X---E----------X----?E-?--------X-------o---?---M---?----E---M------------------o--o---M---EEE-T----------------E|----o--B----------B---|--|---------E-X|-oBf
m--------?----o---M----E-------o-------E----X-------TX-?--------XB-o----M-----M-----------T---E-o?o-------o----------o---T-----E--|------B-M?----M---M?------X---T------M|--M---EM-----BM-?----E--?---MX
XXM?XXXXXX?MM?X-EXXBXEXX-XXXBXXXXXXXXXXXMBEXXXXXXX-oEX?MXXXX-XXXXX-XXXXXXXXXXXXXX-XXXXXX-XXXXTXXXTB|XXXEXXXMXXXXXXXXX?MXEXXoXXXXXBXXXXX?MXXXXX?XMXXMXXXEMMXXXXXXXXXXXXXXX?XXXXXXXEXBXXBooXXMXoXXoXXXXX-X
