-------E-B--M------Mo-----------oo---X----------?-BM---------EB---??----E-MT-M-----T----Mo-E-E-E---X---B-X-XB-T------B----o--XoX------MX-E---o--T--MX--------M---o|XT---M---T-------?----XX-----B----M--
---------XE----X--MM--------??-XM--|X-E-----T----o--o-?-o--?ET--?----|M----BB--BB------To--?---MX------M-|--?-?o--o-XoXo---?--|---X---|-XT---B------|---?---XoM-----Xo-------X-------T--X----BE-------?-
-E?-X-EM------X--------------|-BMEo---|----Bo-|---X-----X-MEMo------E-E|M--E-M--EB-------------E--M--MX-X-X-?|X-MB--------o-----M-X----??EM-----------------B---|o---E--B------?---X--?-E---MB----M-E---
---o----XX-----o---T--?--E----MX--M-?B-o-E--o?----------XX--X-E--X---X------------M--B---?MM-----BX-B----M---|X----?---?------B-BoE---------M---M-ooB---E---X--E-M----------o-M---X---X?-X-X---o---o----
-----BoXo--M-M---XE-X-----------B----------E|------------E---------BT-|-o--------M-?--XX-o----?-----o-E--|--E-------ooB-??|--|---M-o--?-o---o--o----?-XX-----o?-?-----o--?-----------B-B------?E--MBB?--
-M------XTT--X-M|----B---?----?B-E-----M--------BEM--|----M-M------------?------EX--TM----BoB----o?-Bo---T--EB-----M-----M------------?--o?X-------Mo-----X--E---BBBB--E-------?X---B----B------T--E--T-
--MM?---MT--M-o--------M-Mo--B--X---X-E-----|------BE-?T-?---B-X-|-MB--B-E--------|------|?---?---E---MB?----EBM-M-----To---B|T---XBE-------------X-M-X-o---oME-B--------?-----|--T----B----TB--?BE-----
-----|?o--M?------?---B-----B|-----X----M-E--T----?--T-----|----|o---B----X-EE-EBM-T-?----oM-?-E-?-----o----B|?B-M-----o--?-------|------o--?o---B---E------T---B---M-B---X--?---EB-M-T--E----------?|-v
-??Xo--E-----XX------Mo---B---|-----|X--B---X-|---------o----M-M--o-----?--B-----o------E---M----oo-----?--oM-----E-----Mo-----|-B-M-|--BXM|--B----o|-E-----M---T--M--o-T-|-----Eo---?B-------B------MEf
--T---B?XB--|---------------o-E-?-----B--------------T---------B--o|--------M--B-M---X----X-X-EB----B--o---X------o-----M-EXEEBXT-X-?B--------?E--XX--B--o-E--M----oE|BB---M---M-X-B------X-------M---?f
-----------E-EM----X---B--X---o--B---E------B------E--?--?XB---MB---E-?---X-?-------M--X-E----X---MM-----E-E-T-----T-o-B--------E---E----X?--M-EXEX-----oMBo-|---o-----?-|X----?--o--M----M-Eo|-----o-Tf
--B-|---B--oMMM|---BB--B-E---E---X----?---oM--X-MM-o---M----B----|--TM--oo-|-------E-?-T-o-X-E---?--?-XX-o--o---M--|--|-?o---B---o-B--E?-E--------------??ME-EBM-?-------E--oX---o----?-o|--XX-oEB---E-f
----T-----M----?----M-M-M---------oX--Bo-TX---?o----M--??|o-o--M----EBoM--------??----B--EX-----??E----oMoB-|?------BX-----?-------E---|X---T|-E--B----B-------|--|-|---B?M--?T---M----X-Bo-----------?f
-B-E--M----o--------X--TE----EBM----E?---oM-|--o--B--o----|--B-----------B--|-TB---o---X-o?--------|---TET----------------M---T----?---X------?-----o-E-----o-------?---X-X------?-----M---X?------?MM-f
m-----XE---o-T-?M------EE--o---M--?----?--M-o-------M-M----E-----------o-o-o---?-oE--B----------M------o---M-o------E-??o----?-o--oT-X---oX--MEM------M--E---|--E---B---------|--BE--?X--B-------X-X---X
XXXMTXX?MBXXX-EMBTXXXXMXXXXBXTXXXBXXXXXXoXXXXXX-XXX?BX-XX|XXX?MXXXXXoX-XTM-oEXXXXMXXXXXEooXXXXXEXXXXMEXXXXXXXXMXooXEXXXMX|-?XXXXoXXXXBXXEXXMXXXMX-TXMXXXBXXXXXXXMEE-XXX|XXXXXoXXXoXXBE-TXXXXXX?XX|XXX-XX
