----B--|-----------M-T-E-MM-------o-------M--?B---M------E------------|---?--?----------M---------M-MM---T|--B-o---B--?-|T--?-----?X-o--M-?---T-------EX|-------ETT----------E|T-------X--X-o|-------X--
--B---?-----T-|Xo-----E--------X------M---B--XE--E----------X------MTMM---o?-?--M----------BoE--o---?--E-----X--o-|----M---T---EE---M-TT-T-o|X-o-------X--?-T--|-----------?-o-------?----X-|---------B-
----BE-X-------------|-------X--E---B------?E--?--------------------TMM--B-M----------------|---o-E-?o------X---------M---------------------------B---------?-----?E-T---?B---o-o-MX-|o---o-o-----------
-o-o-----------B---|o-o-E----|B?X-T--M------T------oM---X-------?--?---??-E-Eo----E-E-------?E----E-------oX-----o--|------------E|-M----------XB---------MMB-EEM|-X---T-----o-----------o-E------------
-X-?--|--M---EBo-----M-------E-E--X---------?------ooB--------T----X---------M-o-XB--XM---E-----B------------o--------------?-X-----------T-----------oXM----oX------T-M--|---B-Xo-----X--?M------------
---X-----M------?-B-|----------MB----T---M--X-?--X|--B---o-E--|o-----E-E------?oBX----o-|-----oEXM?---MX-----E-----?----?--ooM--E----|---XoB-------?---?E-BBX--------MT-------------X---o--------XX|-BT-
-----------E--B-|---?----o--?-----XT-----------M--oo-M-------X-B-M-----X-X--T--------X--E----T-?|-X--M-------T----------B-?B---BX-X-EB--------------E--|---------------B?-----M-------oX-----?o-----?B--
-------B?-----E--X--------XT-T---?-?-E-M--------------M-----X-o-o-BM-E---BM---------BE------ME-o-------------?-------|-----o-M-o-X--o-|--B--o--M----T-E-------X--------M-Moo---------------E-----?M|-|-v
------X---E---TEM--o---M--M------T------M---T------M------?M---------------------------B-------M-------oo-E|-------------EM---BB-----M-------M-Eo----------B---M---BM?Mo-o---B---E----T---B-o---------of
-------X--o--------------X-B?--|--?-E--B-----E-B-------------X----o----o|---oB--B|--------------?T-----M----T-------E----o--o|---X--E-BB---B-------To-M--X-E-?X-X--EEBX---T---------------E--X---EE----f
--------o---M-------------|-BM-X------oT---E-B------?---oM----X--X?---------EB---EM---o-M-------B------B---o-M----B-M--------?MX-------T---BX--EE-------XBB-X-XEo-Mo-----?B---XE---|--M-BXX|----o-o|---f
--MT-B--o--o-E-------o--T------XE----------o------------X---B----XMo-BX------M-MMo---X-E-E---T-----T-------E-M---o----|-B--o---?-o-M?-o--T-------------M--?-?--------B--B--------?----------EX??---M---f
-o---X-M--------E---XT-E--E--------B-B-o?------XM---|-E--X--o---oBX---M---------------?--------M-XT-B-------------E-----o----|E---EX-----EM------?--B-?-----T--E---X---?--------------B---BE?|--?o-----f
-----T-X-----------Xo----o----B|-----------X-MX-?--o------E--?--M-X-T-----X--X----B-o---------ET-----o--?--?---------?-|--E--------M--------T--------E-----T----B--|E--?------E-B----M-B--T--------Xo--f
m--------------?-----------M-oE---?-o-T--oB--oX----oEE-----B--MX---|-----?------M?-----TB-----------E|-o--T----X----------|E--||----o--------B----?-X----B------?---B---MX---X--BBEX|------B----?X-?B--X
X?XEXXX-XXXXXEEXXXXXTXXBXXXBX?XX-EXXXXXXXXTXXXXX-?XEXX-MXXXXMXXXEEXXXXXXXX-XXX-XXXXXXXXXX|XBXBXX|BXXEXXXXXoXXTXoXXXMXXXXXXBEXBXM-XXXXX|XXXX|XXXXTX?XXXE?XXMXXXXXoXBMXXXXXXXX|X?BMoXEXX?XXXXXXX--XXXoX-XX
