----o-M----M|---X-M--B--ME------?----T--|--BE------X-----------|-B------------?|---?E-------?-------------o----------------------o---E--|----------T---B-o---X-----------------X---E--EM------------?---
---X--M-------E-----------o--M-----------B--T-X--X----B-----T----------TX-----o---------------E----|-BEB-|----B-|--------T-X---E-|---M---o-------X----E---E------------BEX------E--T--------X-o--Mo-X---
-----------EM-------?-------------?---X------------M--------T|M---M--E-|---------o-B---E----------|------o-XB---?M-----|-M------?-T-----------------M---B-------------oB---------M--M-----M-------------
------E--B-oX-------M-E------M----------------o-?E---M--TTX-X------T-BT-|-------?----Bo----|-o-----|B-----------------------------T-o---?-----M-o-o---------M-T-o--E--o------M-------|---o---|-|--------
-B---M--M-|?M----X---?-----M-BTM-X-?---T-TM--E---T--o----------T-------M--------------?B--------------?X|---E-----Eo----?-B|--------E------?--XM---E?oX--BoE--|E-XoB---------|T---M-------------M----E--
--------B---X--B-T-T---?-?-----o|-----o---X----------?-------?--------E-B--X---E---oo-T-B-----E-------|---------T-----o---X-T|--------B---?----XXM-ET-------------o-M--|------------X---|------M|--T----
------X---X----|-o---------M-MX-----M--E--X-B--B-------T---E--E------T--|M--------B--|-T--ME-----o--------E---------------M-------|-?-------------oMo?------------------X---B----------X-X---|M---B-|---
--------------------E-----BB-------o--E--o-o-------------?--M----X-T--B-E-----------E---EB----E-----B------E-Eo-----T--M------|---M-------------X------o?----o-----X---E-T--o-----o?--T-X-?------------v
-------o-o---------Bo--o--M----E--Xo----X--------M---------------oE----M------------o-?-------?----|---T-|-------Xo-E----|E-T-----------?-EoM------------------o--M------|------M----?----------|---o--f
-T------------M----o----T-E------------o----------M----|o--------X-------------------o---------o-T-------------------------M-------o-M-----|-X?----o|E--X-TM-E----------------To-T----o------XM--------f
--E-E--?T-M-o-------?-o-M-----B---|-M------?-------?--o-------T--M-------|--M-?--XE--oXo-M|------------E-------------Xo------------------?----T----E----o|E---o--T---M---o-----------TB-----|------?--?f
---EXE-|------MXTM------X--|----------B-?o---o--------------o-------E----------o---------T---?E--M------BM-E-------?----?M------X----?---|B------------T------------------------------|-?--X-----------f
-TB------X---------o-B-----B--------E---X--o---M?-----E-oM--X----E---|---o----|--|----X--------MB-E------X--B-----Xo-----B---E--|E-T-------B-------T--o-o-----------||E--T--------|-------B---|--------f
------M------------BX--?--T----EE--o-X-?-MX?o-X-o--o-|E----------M--E-----E-M-----T-o-------------X------?---------------------------------X--|------X----|---E-----B--------X--M?--B---X------B-------f
m-X--?----B-----------o----M---o-------o-E-T---M------T--o-----------X--?---------B-TE-------------?-X-------|---MB------o----X-----E?------B------?-|-----X----T--------X-------T------|--B---|-------X
XXXXXXXXXXXXXXXXXXXXXXXXXXXXXXXXXXXXXXXXXXXXXXXXXXXXXXXXXXXXXXXXXXXXXXXXXXXXXXXXXXXXXXXXXXXXXXXXXXXXXXXXXXXXXXXXXXXXXXXXXXXXXXXXXXXXXXXXXXXXXXXXXXXXXXXXXXXXXXXXXXXXXXXXXXXXXXXXXXXXXXXXXXXXXXXXXXXXXXXX
