---X---M----?--o---oo-|EE----------?---M----EE--E--|--XE-E----B-----XT---B--|-?oo-----------------E---E--------|---XM-B--B--------TX-B|-----B-MB----EXoBXMT-------E----?--E---?-M-----B-|?--------X-----
-Moo----?|--X-E-M----TE----oo---|--B---E-?Xo----o--oM-----|---------M---------oT--M--B---?B----B-------M---E----?-B-----?------B-E------------oM--------MT-M-E-o--o-EEBEME--X---------|---o--?--B-------
-E---BT------|-BM----T------BT--o-B-M---------M-M---|--------?-|-|E-E--T--M-----E--M--------------E--X----|?-T------|---T------|-Eo--|X----o-------------o-T?E-T--EB--E|------B------------E------------
-E--B----?-------------o-??-------M-T---TBE----M-Mo-X-------------M--M-M|o---TTE----o----oo---M--B-------B--X---|-o--o----------?--M-------|----------X-XX----|-----B----M-----------B-M-E--X-----------
--B--?-M-------o-----M-X-o--------E-|B------T?--------E--------XME----|M-E----o-----T?B--B-B------|--M--EoM---E--o--------M-B-TM-oM-E--?-----B---o-o------?B--MX-o-------?--B|----o------|--E--B-?----B-
--oBB-?MM-------E-B-----XE-o-E------|-T----B-------E----------o-o-------B-X--?----------B-B--M-------X--X-----XB---|-MBX-o----E---X----X----B-----------------o---E--T--XMo----M--Bo?------o-|----------
----|T--------B-----MM-------------------E---ME---|----X--|-MoE-?---?------------M-----?--------Bo-------------?oX---B----??------B-B-|--?--M--E----o---------?--------E-?---T-X?-------E---|--BM--B----
-----B-----?-X------?B-oo|?-B--T---E--?-M-----------B--T-B--E-----B----MXM--XXX----|--B-------|--T----o--B?o----B-BX?M-o-o-------------XM--M---B-----XEB?--TT--oE-----------Eo----------X?-----M-----oBv
----?----T-?B-X----M--?-----E-o--X-o----EM-Eo-M---E---T-------T--o-------|E---E-o---------oM-EB-----------Xoo-----oX--?---?-----X----------X--B------MM-|X-------E--------o---T-E?-------------------o-f
-X-----------X--------------X--o---T-?-----------o--T-----E-B-----|M-----E---------o-T---EE----|X-B---Moo--E--M----M-|--o----B--B-X-E--XMM-------?-B--BEE-E---oE?-M-----Xo-----B-M-----------BBXB-E--o-f
----------X-?--o-?-----E------M---M---EMM----?-o-E-|----B---------?-MEB-B--BE---?-B-?B------T-T----|------M--X-------X---EM-----B--------X--M---M-|---o-----B-E----T------M-X----?------o--?B-oB-----B-f
----------o---|X-?o----|E---M-M-------Mo--B---T----E-M---T-------T---------|-B|-o---o---T-|-------o---------------------o--------------Mo------|?-------X---?----oM----?----?XT-MM-----MM-------M----?of
-E-E--------?--------o---X------X-----------------oo---E?Bo-Eo--X--E---B-E?--oX---|-TX------oo----M------T--------o-------E--|---M-|--------------M-M-X---M-Mo-------?o-E----B-X?o--------?--o---------f
-X---M-B--o-------E-T--?-Eo?----B-E--E---M--E---B-|--E-Mo-------oT--o--ME--B----------?E--o-E-|-o-E-EX-o------?---oB-------XM--------------?-E-oM-----oo-|-o---?-------T----X--B|--E-o---------M-----E-f
m--MM--MXB-B----------X--o--|--TX-oB---E--TBM----EBoB------?-----X--?-?-X-?B----|------E---|------E-------X-------o----------T-o---------M---------M--MX?---B?-oB----|-----T-------E-|--B--B--E-----?--X
XXXXXXXXXX?XXXXXoEX--XXXMXXXXXXX-XXXX|XXXoXXXXXXXXXXXXXXMXXXTMXXXMXXXXXXXXXMXXXXTXXXXXXXXX?XoBoBX-ooXXXXB?XoXXToXXXXXXXXXX?XXXXMXX?--XXBEM-XEXXX|XXXTTXXXBXX|T|XXXX?MXXXXXXXXXXXXXX-M?XXXXXXXXXXXXXoX-XX
