-X---MM----------XM--B----B-----?--o-----B-------o--------EB-----------B--------E|-?--------?----M----E---o--------------------------EX--------|----E--B-o-X---?---------------X---E---Mo|-----------|--
---X|---?-----E-----o-------EM---------?----T-X-----?-B---T----B--|-T--------------XE--------oE----|-----|----B------T---T-XE--------M--oo-M-------o--E-ToE----B|------------?--E--T-M-o----X--X-Mo|--T-
-----|-----EM----M-------------X---|o----?------XB-----------|-BE----E----X-----B-------|-T---o---|M----------------T|-|--|-E-----T-|---?----X--E----------------|---------------M--M-----M---------T---
-o|---E--B-o---------o---------------E-?--T-------|MoM--T---X------------------|?----Bo----|-----M----------------------------------oM--?----------o---E----M------------M---M--B-o----B-o---|-|--E---M-
-------XM-|-M-E----o??---EE---TM--B?--------E------o-----------T--o----M-X---oB------??-----E--X-------X|---E-M-T-Eo-E--------------E------?-MX----E-o-----E---EoXo-|--------|--T-M-----------------M-T-
-X------B----o---T---E?--------o---------?X---------M?-------------?-T---M-X--o-----------?----E--E------M|-----------o|----T|----------o-?T--MXX---T------BT-?B--------------------X--------M-M---T?---
------X|---B---|-o-X---------M-?----M-------B-----EB---T----M-E-o-|--------------------T---E----?-?----TE---o-----o----------E----|-?--o-?---------Mo-T?--------TB----E-----B----T---o---X-----oM-B--o--
--E----o-M-----------o--|----------oo-------M---------------M-----E-----E-------XM-TE-------|-E-----B---------------T-------------M-----------------TB--?---E--|-o----oE-----------?----X-?----------E-v
------------------------E-----------E----M--T--------------E-----o--------X---X------??-|--|-|-o-?---B---------T-X-------|-----------------o----?M--------o--o----M-M--|-|-o---X-----------------------f
-T-E------?---M---Bo----------------B--o------|---------o---?----Xo-X-------o----TB------M--BM------------oB--|------?-o?-----M----o-------|EX----oo|------M----M-E--------E--T--T-|M-o-?--?-XM--------f
-------?T-M---------------------MM|-------E?--E----?--o----------------?-----------M-o-o--------o--------?----B------Xo-T----------oT---?---T-T---oE----o--------T------Bo-------E---T---|------o--?--?f
-M-E--------E----M-T---------------X---E?-----|-----E--T--E-oB-M---|E---o-|----o----oM---------------------E--MTT--?-----M-------?B-------B-----M---o--T-E--B-------o-E--B--------M-----?----|B--?-|---f
--B---T--X-----X--E-------------------------B--M------------X----E?---?---------------------------E-----------?--BXo-----B---E?-|--TE------B------------o--|--|---o------T--M---M-------T-BX?--T?------f
----B-------|-TEET--X-----T----EE--o--------o---o-To----------------E-----E-M--?----o-----------B----|--M-------M---?-----------X--------B--------E-------|--------------------B-------T--B-T----------f
m-X-----E--T--B---T---o---BM----?------o-EB-----------T--o-------|------?---|--o--B--E|-----X---X---TX-----------M---B--|oX---X-o---------|--------?------BX-------------X-E---T-T------|-B--o-|-M-T---X
XXXXXXXXXXXXXXXXXXXXXXXXXXXXXXXXXXXXXXXXXXXXXXXXXXXXXXXXXXXXXXXXXXXXXXXXXXXXXXXXXXXXXXXXXXXXXXXXXXXXXXXXXXXXXXXXXXXXXXXXXXXXXXXXXXXXXXXXXXXXXXXXXXXXXXXXXXXXXXXXXXXXXXXXXXXXXXXXXXXXXXXXXXXXXXXXXXXXXXXX
