--------------------------------------------------------------------------------------------------------------------------------------------------------------------------------------------------------
--------------------------------------------------------------------------------------------------------------------------------------------------------------------------------------------------------
--------------------------------------------------------------------------------------------------------------------------------------------------------------------------------------------------------
--------------------------------------------------------------------------------------------------------------------------------------------------------------------------------------------------------
----------------------------------------------------------------------------------------------------------------B-----------X--------------------------------X------------------------------------------
------------------------------------------------------------------X-------o------------------------------------------------XX--------------------------------------X------------------------------------
-----------------------------------------------------------------XX-------------------------------------------------------XXX-------------------------------------XX------------------------------------
----------------------------------------------------------------XXX------------------------------------------------------XXXX---------------------------XXXXXXX--XXX-----------------------------------v
---------------------------------------------------------------XXXX----?------------------------------------------------XXXXX-----------------------------------XXXX-----------------------------------f
--------------------------------------------------------------XXXXX----------------------------------------------------XXXXXX----------------------------------XXXXX-----------------------------------f
-----------------------------------XXXXXXXX------------------XXXXXX---------------------------------------------------XXXXXXX---------------------------------XXXXXX-----------------------------------f
------------------------------------------------------------XXXXXXX--------------------------------------------------XXXXXXXX--------------------------------XXXXXXX-----------------------------------f
----------------------M----------------------------------?-XXXXXXXX-------------------------------T-----------------XXXXXXXXX-------------------------------XXXXXXXX-----------------------------------f
----------------------------------------------------------XXXXXXXXX-------------------------------|----------------XXXXXXXXXX------------------------------XXXXXXXXX-----------------------------------f
m-------------------------------------------E------------XXXXXXXXXX-------------------------------|---------------XXXXXXXXXXX-----------------------------XXXXXXXXXX-----------------------------------X
XXXXXXXXXXXXXXXXXXXXXXXXXXXXXXXXXXXXXXXXXXXXXXXXXXX-XXXXXXXXXXXXXXXXXXXXXXXXXXXXXXXXXXXXXXXXXXXXXX|XXXXXXXXXXXXXXXXXXXXXXXXXXXXXXXXXX-o---XXXXXXXXXXXXXXXXXXXXXXXXXXXXXXXXXXXXXXXXXXXXXXXXXXXXXXXXXXXXXX
