--T--oX-X?--X-|B-E--M|B|?--E-EXM-|T-----E-|---oT-X-TT---BBMoE-MB-XM-E?-M?---?o|-?--B-M-|-E-M-M-o-|--M--B-TX---E-EMM-Mo-B-----o-|E---E---BB-X--Mo-|---E--M---|-E---?M-T?B-E-o|--o-o----------B--|-T--XT--
------X-EM----ME---o-o-?--?--B--?---E--|-o-ME|-oX-------Mo-X--M?--M-M-B|-o-|-Eo-----E-o|--ME--T-o----?M--------------T-?---------Bo-T----------MB-EM?---o------E---oMoo-----?-|-?BXET---|--?--o---T---?-
----T-M--T-M--X--|B?----?E-B--X-MoM?-----|-|?-?--MoT?----|---------T||---?Mo--?E|-XX-M|X-o-E--T---ET--M-X|----B-T-----oE-X-|-X-|M?XoM?-?-B?M-----B-E---|----B--EX----?-----?-o|---E-EM-M---?EM|-----E-o-
-T---MM------|---E-E--MM-M-BT-------T?-oo-B-T----M-----BXX--M-oT---M-B--E-X-oT-M|ToM----|?---?o-------|MT-MoT--M---oE-B-M----B--M------B-|X----?-----EX--X|-|--M-o--|-?---E-----B-BE-o-|---EB-Eo--o-----
-M-T--|BX--Mo--?---ooo-ME|T-M--------Xo--MB--BMX?---BXT---|?--X----o----M------?B-B-TB------|----ET-|M-----oEE---E-?------MXT----|?|B----XM?-------------XE---o------Bo-B?MoT-?-E---E--M-B--o?-B-X--T---
---|B-?------o--M---EM-M-M----M-TT--MB--|M-BX-----M---M--MT----XB----?T-oM-|---o--M-X-ET-B----E--|X--Eo-X-B|M-|T-ET---|o---X-----oX---?B?--|?---TM---X----B-TM--M-E-B|-------T-----B----M-o--o--?-------
--BX-----|-|----TXX---o-M-X-X-oTT-B?------?TBM----o-X---XXXE-X---X?T---E-------M---|--B--------o--------Eo-----??--MMX||-EBT---B--T---EXT-M-BB-M----o--X--EE-E---------?E|Mo---|--T??--------TX-----|---
---MM||--M---X---XX-?------?-B-------E--X----T-?-oo--M--o-|M-TT-------BM-o--o----M--M-oM--?--B----EMB---E---?--|TE?M-----XX----oo?XX---M----o---?--|-TXM-----XE-o-B--------T---E|-----T-E|o-?T|?-?-----v
-o---|--E---o?T-M?--XE--M--M|?|X?B-X--TM--EM-B--o-XM--------TE-B?---?o-T-?-T?-E--M---?-oE--Xo--M--oMo-E--o?---B-|M--?EM-----?-?E-----?ME-TX|---?oM|-X-ME--??---X---o-B---E----?oTX-?o--------B-------EBf
------T|-X?-T--M-------X--oM-T-o-o-EM---ET----ME-X--EB---?o--B-XTXo----X---BE|--E-??--E|E-----|o--XM-----E--M----M----|--?----M-Mo----o-XT---|-?XT---T?TE-|-----T-----M-T-EE-X----T-B-X?X--|--?T--TB-T-f
---BEo-E------E-Eo--X-o-E--E-E-X-|?|-T-ET-B--XM--T--o-E|-M-X--------T----XET----?--BoE--o?-o--MXM|---T---?---XX-----?--|?|o-MXo-M-----TX--X---------o-|-----|-X------E--EEoMTB--o--T-|TX-E--BX?|-E---Eof
-E-TBMXo---o-TM|-|---?-E-----MMT-M--|--?Bo?|X-ME-oM-E-M-o-E---X|?---T-B-X-T--M---?----------XEE-----M|TE-B-o-E-------M---|M----M-|---TE|oM-X-T-X-M?T-BEM--E--TT-M--XBXM---X|MT---|-X-----E--|T--o------f
-M-E-T--oM---M--B--T--E----|E--BT-B?-------?|MB-----EoT-X----X-?--E-T|E-E-XE-?E----T-B-o--|-B--------?-|---o--ET-oE-?--BoMo-TB?T----EXo-o-------MBo--BB?X?---|-?-E?B-o-M--EMoT--X---E|XT-?----M--Boo-XTf
--M---E-M-M-----B-o-B-T--|oBTT-B----o-?--Bo--o-?----M-|BM---MT--o--E|M--------EM-ooM--------o-ME-----M--B---B---E-M-M---BM|B---EE--o--------?M-EB-|-T|-M---o|---?M?---BX---?-|E-X?--?MB---XXX--?E-|--BTf
m-----E-----------??-X|?---o--B---X-TEE---B--B-BM-|?M-MXBBTB--BTX--EX-|X--TE--E--T--MoT-M?M---B-||-E---|--oB--XE-|BE|--To-?XXXMo---|-M?oo------TX?BT----TB-B--EM--MX-----T------|-M-BXo-E?T-||E?--BX--XX
XXXXXXXXXXXXXXXXXXXXXXXXXXXXXXXXXXXXXXXXXXXXXXXXXXXXXXXXXXXXXXXXXXXXXXXXXXXXXXXXXXXXXXXXXXXXXXXXXXXXXXXXXXXXXXXXXXXXXXXXXXXXXXXXXXXXXXXXXXXXXXXXXXXXXXXXXXXXXXXXXXXXXXXXXXXXXXXXXXXXXXXXXXXXXXXXXXXXXXXX
