-X-?--MM-------M-------E---------E-------BB?-------o-----E-o---T-X-M---EE-M-MXB----M----E-------M?E--ME--E--M---oo--X------M-EoE---XX-?-M---o---X--M--E--E------TM-o-----X--B---|---?----X------M-------
--X----X--------------T-------M----?---------X--BoMX--X-?--------E-?---M-M-M--X------E---B-------------E--M--?--?B---B---------MX?---B-----ME--oM-T?oX----o---|---?-X--------EM-----BE------E--?---T--E-
--|---------oo?-o---------X---MBX-EX-X----E---E?-oME--------?E--B-----?--M-----o------?--EB-M--BMT-o--?XT----Bo--?oo|-oo----B-|----Xoo----?--X---X-X-o-|----?B-------M----o-?Eo---?XX-------------E--M--
---?---M|XEM----M---X-?-XBME---?--T|-M--X--|----?------BXoT----EBoM------B-M-X-X-------T----E-?-B---E-----|BB-?B-XM-----X--X----------X-----?---?---M?------B---Mo-?M-------o---------X---?---E---B-?-X-
-----|-o-----MM--o--------XBE--E--B---T--BB---------oX------oX---EE??-BX-----o----E?---|M-BXB-o-----|?-M---|-----?oB--?M-?--?-TX-E----?-----?----T-E--E-M----o-??-----X--B-X--E--X?------|---X-E-?---?--
---o-X---|E??-----?--B?M-T----?-B-----|--------Eo-X------T-E-X-o--X-ME--|--T-M--oB--MMET----oEE-B--XEM-X---|--BT---o----|---X---E--B-----X--o-----M-B-----B----------?-?o---|-E---B------------B?----B--
---o?---B-?XE----?--------?---T---M-------|-E?-XM----?-X-E?-----X|-oT---------B--E------E----------------------MoEB-M---?-E-------TE--TE---o?--------M------Eo-o-------?B-M-B----E------M---E-B--M----o-
--B--M-o-----ME--E---B---X--X---?M-?X---o--|----MX-E-o--E----E----o-BM-X-E--?---M--------T-E-X-T-E---------E|-T-EB---EB-----?M-X------|---?----------?--------X----X---EEM?-T----o---o-?-----?-o-M-?--Ev
---|--X--E-X|------BB-T-o----X-T---?B-----E---------o?-----|-----------------E--MBM---E---B-XB-M-B--T---XE-X---?-B|-B----ME---B-B-----------?-XE---Bo---|---M?---BM---?-X--o-?--o-B---M----------M-B-B-f
-T-------------------o?--------BXX--oo-----ooETT------T-X----B|--??X-E-EB--o|B--X-T-EE--------o?-B-o-------B-E------o---X-o--M?|--X-EE-BX--------|X-oX--o---------T-BB------T-B--------T-M---X-M---BM?-f
--E----X--------M---o-B-oM----BXo---B-B--BM--X----o-------------B---------X-MBo|--------M|E-----|--T----o---?X---M-?---?-o---E-------o-M-o--E---oM--BX-??-E-?---X-------?---M-----------B-M----?XX-----f
-T----B---o--oT-?--M-----XTo--M-E---o------|-----B-o------oo---|--ET-B-|oME|--B--EB--o?E--E--X-E-|---X--?-E----o---E-----X---B-X---M--M-X---?-------B|--X-M---B?-M-----BB-ET----B--E?M|-B--E---o---E-X-f
---B-?-M--XTXE-?------MEE------ME-E?-----E------o||XE-?---o-o-oToo---o---oM--??-B?-M--?B|-X-X--E-?----M-----------------B---X--?E-B-----X--?-----?----M-?B|--E-E-B-------M-----E-o-------M?----------B-f
-----o-----EE-oTE----E---?M-E--Eoo---|----o---X----o--X--E-?XT-?---M--X---?--E-E-T-?--?T----XoE--?o---B-M-|-o|-----o-------------B---||------o?------X---X-B---B?E-o--------B---X-E----B-----?|-B--?MB-f
mM|--X----------B--B---Xo-XX--|---E---MMEo---oX--B------------M--E---E----X?o-B-E?---MB--EX---o--X-------oE--?ooBM-----??-M-?-M-XB-BBE-X--B-EX--oE?-X---------E-?---B?-----M----E|-X-X-B----X|-??--E---X
X?MXXXXXXXBXXEE?XXXXXEXXXo||X?MXXB|To|oXXXXX-XXXXoBXXEXXXXXXXXXX-oXMXXXXXX-XXXXXXXXXXXEXXXXXXXXXXXXTXXXXX|XXXXXXXXXo|XXXXEXXXBXEXMXXX?XXXoXBXXXXXMXXXXXXXM-XBXXXMXX-XBXXXXXoX?XMMMXMXX?X-XXXoXXXEXXoB-BX
