---o---?----E----E-----M-M--B-X----B-X-o--X---XTo--TM?--o-o-X----|MX-MX--B-?---M----B----E----B---E---M---------------M------EM-|?XB---MM--B---------------M-------|E--|--|B-B-----X--Bo---o------B-----
-?-?----B-----o-TBB-E?---??B--MoB---E--T---------------------------MTo--T-----?--B-T-----E----B-B?Mo---E--------E---X-X-oo----T---M---B----M---B----M---X-----?o-?X-E-----?-------------|-----B-M---o---
--X---B----M------E----|---BT?o-E---------EM--o-----?---B---To----X-------oM----?|--E--M--E--|---|---|M-----M--?--oXo-BE?---XX-To-------------|?--E-o-----------X------o|M---X?B----Eo-BEM--o-B-X---E---
--B-?-T-T--E-----B---B-|E-M---|--------E--E-------o--|X-----?-?----?-M-X------?----XX--X-E--B-BMM-----------o--E------MM----o--------M--BB-?---oT-o-M---M---------------X--E--M-|-?----?---E------o---X-
---TT--B--X----------------B-----T--B--|-|-B--E------E-o-E------X------?-X-------Mo--X----o--?--XM--o---------o-T-----?--|--E--Eo-o--B--?o----MM------T--MME|------X-E--------XXM----E-------BXT--------
--o?--?------T-MM------T---TEX-----E---BEX-----E-----M----E--M---XXMEo?--XB--Eo-------------B--?-o-----T-E----B---|X-oo------E---B-----X--TE--Eo?----oo-?---?---------B-------M-?--X---B-----T----o-----
-------?-MM-o-TMT--|o----------X----|o---E--o-BX---------------E---B---|------?---E---|T-|-EX------?---B--|----B-------M----X-M-o-B--o--E--?---EXX-|?X--BE---M-M-o----o---XM-M------E--o--o---------E---
--XM|--?-?--M?-T----To-X-------X---B----X--X----E---oo--B----X-XMB-------?---|Eo----------B-o------o-E----E---?---|-o--------Bo-----|B--o-B------|----|-------E------|-------T--E-oXo---?X----Mo--o-EB-v
-XBX--------B--E---MBE--------E-o---M-------------E-X------E-E--T--------B|------B-?-----?-----?--B-BM--o--oo-X---M-B-E--T|--M-?-B--XT----B---B----T---------M-XM----X------B---oM?--B-o-T----B------?Mf
-?------------o---T---TE-T---|----MoM---------M-X?T|-|X-Bo-B--B-X-?----??B-------------?--X--X---M---X-T---X--o-B-BX?-o-------BE-------?-----B--|X|-------T-X----M----------B-o--B----MM-M-------X?----f
---BoMX-M------------X----M--------E----X---B------E-----B-?----X----XM---E?--E?-X-----?-BM-B-------?---?------?---T?--X-----T-------?---?------B--------M-E---o----------?-----X----------B---BX-M-??Mf
--?M--B----X-X-X|XB-------T------?--o-B-|----?-o-|------o------|-?-------BE-B-MEX--E--XB---E-?-oo-X-XBo---B----?--------B-?----T--o----T--E-|--?---------o---E-X-B--B--B--BB--o-B-------E?---B-X-----?-f
----?-------E--|-------E------BTX-?--B-?---X------T-o----X-X--------?----?M-----oE-----oE-------|-X--B-X---B---?--M-oM------?---EX---M--M--o--E--X?-T-----XE-oE--M?--TB---?------?-B---X--B---??o------f
-M-E----------E--X----?MT------------|-o----M-B--M-?-E-EX--E---?--TM---??-B---------B-----T-EX---B--?-M----MEE------?X--M-M---EX-------EB-X--o---E----o--------X-TE-X|-Mo-X---------E----?ET-EM--X-B---f
mo----B---M-----XM--M--------M-oX-------?---MB-----E-?---B------B-E----?-B-----|-M-o-----B-------?-BM----EB-E-------?--TE-----------|o----oM---X-XXM-o-?o-TX?-|----BX?-----o-----BE--EM----X----M-EB--BX
XXXXXXXTXEXXXoXXXXXEXXXX--XX?XXXTXX?T-XXXXX|XBXXXXXBEXEXXXBoXXXXXXXXXXXXXX|XooXXBTXooXXXoX?XXXXXBXXX|XXX-XXXXXXMXXXTXMXXXMXXXXX-XXXXBXoXXE?XXXXXMXT-XXXXXXXXXXXXX|EEXXXMXoXXoXoXXXXXXXoXX?XMEXMXXoTX-XBX
