-?--E-EXTM--M-o----------B---EB-------|--o--XX-oT--||--?MXXTTX---X-o-T-TM-EoE--T-?E--E-?X-?ET|o-o--X?-X-----M---TB-M----X-BXMB--o-------M?--M-----BEoM|-T?----o-|o----X----X-----M---M------TT-----oE-M-
-----?oMo|-oMXo----BX-M-o-XB---oM---E-?--------M-Xo--T--?XTB---E?-----MT-o---BMMo--Xo-?|oTo--M-|-----?--?ET--E-ET-|--T|B--EM----|-?MMo--|-oB--XE----B-o--T--E-----M---?--X-M--X--E----|X|--MT--|EM-M----
--oX-B-T--X-?----|-X-EB?E?-TT-M-MB------------MMo-TB|--|o-X-M|oEo--TXB-TMX|-XME-----E-TX----?E----XM--XoB--o-TT-?------E?------M?-oooM-BM-BM-o-------?--TBEB---||?-X|T-M-oT-ME-XE--ETXEMEMMo|---M-----T-
--MTMTX-o---?X------T---MM---|-o-Bo||---oE-?B-B-Eo|MMMMME--M--ooE-MB---M----?--||-oE----M-X-----X--------oX-E-E-----M---X-Bo-E--B----B--oM--------E-M----?--o-To--M-o------------BX---MT--|----M--TE-|--
-M-TEBE-B?--o-E-B?---X-|M?Bo--T|MB----ME--TBMoMTX----T-MoX-E--EE--?-EX-BETBT--X--EM-E--oE-----MXo--EoE----B---|-EX----?-MX--?--|?---E------BE--|---E--|---MB------|o-T|--MX-|MEB|---M-|-B?--M-?--M--BE--
--EE----MEM--EE------??MX--B-?--ET-----?---|X?--|----|MX?-MM----Eo--BX?---??-M-?-M----T|M-?E-?M---X-----E?-?BE---M-|B------o-?oB-MB-?X--o--ETMM--EETX?o-?-|-B--X--------Too---E??---T-X?-o-o-T--X-?|----
-BT------------X-|-T-B-o-EB-M---M---T-MB|----ME---------?|-----|---?X-M--BoM-T-XX-M-T-E-EM--MMM-X-EE--?--o----|?-|X---|-|---M|--?-BMoT-X--B?B-?-XB-------?-|-----|E-X----------X?o--?o-E|EE--?M-----B---
-M?M---o--T|-ET--E-T-X|----o-MB--X-|----o---M?X---BT|-XB-------B-B----------XX?-?----EE--EXEM---------X?-TT-----|-B--X?o-X--X--X|-------TEM-E-MB--BX--E|TME-----B-B--M--M-o-E--|----?||o---|----Bo----ov
--TEX-M-oT-M-----?-ETB--MB-o?-----X|-o?-o|----E--T--B---|XE---?M--|-TT--M-T-?-oX----To-X-oE---E-----oo---|-?-|---oE?-EBXXEoM--EE--E---|-o-T-|?--M--XT---oE--?M---BX----T?-----?-?---o---?--o--B-------Tf
--MBoMMMB----??M-E-|-T---T-EX--Too?-oM-M--o----TX-TB------?ToTET--|?----B----BBE-X-TE--T-M-----|----T---M-X--Mo-|--T--E---|MB------E-----Mo---o------M-T-B-----E----?-TM--------XMo-M--X---T--ToT---E-Mf
-ME|EXM---MBXMo-ooXE---o-E|-MET---o----?oX---?-TM|TE?--B----X--MMo--|---X-?|o?--T-M----|-o---?----M-X---??-MT---B---EE----X------X?XB-M--?MM--E|?--|-M---T--Bo--------B-|-M-o------E-------TE-|---X-T-|f
-o-To-TM----E-|B--TMTB---M---ET--|T-|||---o-M---To-----TM-o------X||--oM--?-M-B--?-T|--T-o-XMo?|-X-E-X|-B|-M-B--T-M----X|---------MTT-oX|-B|-EM--M----------XM---T|o---X----Mo--B-----T--T----X-o--XM-Mf
---|---o-o?----B-------|E--X|--o----EX?BT---?-T----|E----BE-B-XTo-------?Bo----M---M---o------BB?M--T--ME--|-X---B|-E----o-?-T-E-??-ToBTT-TB?-M--o-M|---o-|E-----XT---?E----E-?X--T------Mo------|--EB?f
-o--T--EB--TE|TT|----M-E-M-BXo?EMX---T-----?o-EB?-oo--|-|T---|-TE||X--Bo-|------o----|?|o?-T-B--BE?E?|BM-?-o-?-M----MX---o--Eo-EEo-EXE?T-o----T-?o--BT-M-TT--?-BB-X-B---o-X?--?-T-oET---?---X|--oX-B-X-f
mTX---o?--o-BBT-T-X-M--E-o??TME-BE-E-X-X-?-|--MB---M--|Xo-o--T-----E---|------?--oB-M|XX--EB---X-?--MM--M-?|MoToB-EM-------------T---E--o-----B--M-T?|T-|-X--XX-?-E--B-o-BM-E?-Eo---TM|E--B----M---B-?-X
XXXXXXXXXXXXXXXXXXXXXXXXXXXXXXXXXXXXXXXXXXXXXXXXXXXXXXXXXXXXXXXXXXXXXXXXXXXXXXXXXXXXXXXXXXXXXXXXXXXXXXXXXXXXXXXXXXXXXXXXXXXXXXXXXXXXXXXXXXXXXXXXXXXXXXXXXXXXXXXXXXXXXXXXXXXXXXXXXXXXXXXXXXXXXXXXXXXXXXXX
