---?-EE?-----o-M-T---X--TX----?---ME?----B---?----B?-?M--Bo------T--M--XMX---o-B---oB---------M-?B---X-----------?--X-T---Bo---|-----X?---?---TTT--|------o-B------?-XB-E--|o----------|----o-E-EX--MX--
-|B--|M--?T-oE|-Eo-o-----------X----B-|---B---X?---T-E-X--X-B-X-M---T-M---?----------------XX---?-To|B-----o------|----M---?-B--BXTM----------o--?--?---------M|--------E-TB-----E-M-|M---X-XXM----o----
-XB-B------------EM-?--M--MT---X-----X-oB------?---BE-?-------B-EB-XEXE-ToMM----oM-----T-BT------B---o------X--oBB-------TX-X--oX---E--o-------?---B-------|T-o--M-o--E-B--BM-oT--oM-Too--E---------M---
---B----E-X-|-B-T-------E---X-XMXXB--M-------T-ME-E-E--T--------?X?--|----E-B-----EB-M----BBXM-M--ooo--|--E-------o------------M-EE-E-|oo---B-EoBo-----B--?M-----X-XM--?-------E-?--?----------M--X---|-
---BB-----M--X-------ET--X---X--?--|----E------M-BT?----M--TE-------X---E----MBo-----XMT-B--X-X----------B-M-X---M-E------|-------T-----X--------|-----------------|-TEB-MM----------MTX---M--|-o-----?-
-ME-------TB----?---|--??o----MM-Eo-------MX---M----M---|E-?o--?------X-MX---B---B--?--E-M---|X-XMT-------o--EX----------|-------o-------E--o-?X-X-BM-oo|-BX-T-----X--B--|----T?E---X-M----|-----XX-----
------T?--?------?--?---?o--------XT-M---------------------------?--?M-----ET----M--E---T----T----X---B-o--E-oTB---------M-X-BM-----EB--E--|X|--?--XE--|-X--E-B---------?M---M--X-----?ME-----o-B---|---
-----------E---------T?---|----M---o-M------BB----Eo--M-----?XMM-----B-XB-Mo--Eo-XE-T-X----E---T-o---o--E-B--?X----M--X---Mo----------E----|---T--o------X--XXB-E-----o-EBX?M----oXo--o---B-------M-|oEv
-?---To------o--ME---T|X----o---o---X-E-o-|--|---B?--M----X----E-------|Bo-------X-----------E-----------X-------MM-XB---TB|-MBo-------TE---MBX---B--B----B-M?---E---T---M-E--o-?-----To|-B------E-----f
-B----------?o--?--o--?---M--X---?-B--TB-M---E-----o-MB-----|--B-ToB-M--|--|---X---------M---o--E-E---EX--M----X--E-M---B---X|M-??--?--|---?--?---T-B--o----T?---M--E-X?----o-?-E---M?--E-------o|-o---f
---E----X--X---?--------------o----------M-----o------X-o----X---?---T----EM----o--o--o-E-?--BB----E--?-E---X----|--Mo-----BT------T--T-----B---B---------X--o--?---|----M?----o-o---Eo--X-------X-----f
-|MT-|-------o--?-|----?------MB----o-X---?-ToT-----E|-|--|-Xo--E-|-----M----M----T--?---M-MBo-o---E---MX--|--------BB--o-?-X-------X---?-?T?--oM-o?---M-B--------oE---XXB-M|TM--?-T-----o--MX--B|-----f
----?E-E-------?X---------T---M------T-o-M-----Mo--?B-X----?|----Mo---X-T|---o-?-T--T-------|--M-XTX---T-?---M---------X----B-E--T-X--o-----B----?--?|?-|--------M---M-X----|--M-E-E---X-|?---?-|o-E---f
-X-X?-M------T-X-BM---?-X|?-T-----X--X----Xo---B?----|-X------X--E-----X-----X---E---B----?----?--?----oT---E---------T---XB-X--X--M----XM--T--||--?-?-------M--XT-M---B-EoX---X-oX--o-BEBT-B-?--------f
m-X?--------?-----?-Eo-X----oBM-------T--?E-------o-------B-M---------M-------XM----E?---B-----E---M----M-o-XBo|M-X-----E-E-B--E-o---E--E----|----?--------X-----?--B----E?B-B-?---------B---?--o--Eo--X
XXX-?XXXXXXEXXXBXXXEXXXBXXXXXXXX?EoXXEXXXXTXX-XXB-XEXXX-XXXXXX?XXXBM-XXEXXXXXooXB?MXXX-XXX-XXXXX|XXXXX|?oXXXXBXoXXXMXXXEXXXXXXXXXX?XXXEXMXXXXXXXTX?XBMEXXXXXXXT|XBE-XEXXXo|BXXXX--XXXX-EXXEXXX-XXXXoMXXX
