X---E-M--|---M---|T-X-E-XEM-M-----|-EM---M--BT-ET--T--------BX----Mooo----T|B--?-E-E-----M-E-XE-E-?--|X--X--E|-EoBEB--T?------|-o---T-o-XEX-------B-o--MT-B-M----E---E--X-?XB---T---XMB-|--Eo?-??------X
---E-Eo-o-----|-?--B------XB-XM---X-T--X-----X--o--?---E--B---X-|--E?o-?-------M-T|B-X?XT-----B--o---?MM--T--E--T-?-E-BB-|E-------M--B-----B-o------E-?----E--o--MX|E-E-?-M??-----T---|--?|-----E-T-|-BT
||--MBEBXE-M----?|--oEE?o?--B-X?----E----B-XE-EB---o---EM---EooX--E-X--TTXB----o-|-X---|-?BEX-|-MT-T--Xo-o?oM?E----B-X---oM-X---T---o|-B---o--?-B-?-X?X-M--B-EBT|MTXM-M--o----oTE--E------M-ooT------?To
E-ET--o-X--X------X--oM---M-o---EBo|-------|-----B--M|X-BTM|-ooME|MM-X----X---B-|?M-o---M--Mo--|--T|-------E---?oM-Mo--X---------ET-X---o--M|XXT---------?--B--oBM---------oT-E--B?----T-||E-Xo---|?-|Eo
|T?|-T-----E--E-|X--|------o--------|?---M-------o?M-----?----?E---??B-B-|-?B-?--T--|--XE--?----M|M--E--T-MX--|--?---|?--E-?--M-?-----|--o--EoXM--M-------M---BM---Mo---MoX-----XM---?X--?--|M?o?o--B--o
XT-E----E----XE-----EoBMX-MB-|M--T-------|--T-o-Mo-EB----oBM-|---o?---B-E--|--M----?---BM?-Eo?------o---o--M---M---o-o-MMo---Mo-X-----?ETT----M|-|-MX---TBo--------------?o?o-oB?X-M-----o-o-T-EMM?o--|B
?-?--o-------X---|--X-XoMEB-MoM|BToEB-ooT-BE?|E?MoT-B-----------|M|------B-Mo---|--T--E-M---X--BX?M||M?MM-----|-T|---T-?|-o--M----M-B|XM-o|||-o--B-M---BoT-?o-oT-|E-XB--X--X-X-X-o--XM-----?M-M-B---B--T
T|-TT?--M-?--E---E---X----?o?-B--|--BMX|oMM-T-X-----T-oTEM-E-|B---ME----||T------E----?--o?-E-ET--XTo--MXB|-----XE---B-o-X--X|T---EMXo--T-o-MB|----??--|TM-E-----M------T--M-|-?M-M--T------T-M-Eo|BTB-v
?-ME---B---X--M?-?--B---M-ToX|E-o-XM-M--o-?---X|TTo|-|BT-B---B?M-||T---X-E-?--oX--B-TT--?-----M--?MX?--X--T-----B--?M-Bo-MoM-MEE---BM?oBoE-M|?-BBo-M-M---E-o-M------EM-?-oE--M|M-Too-XX??-To-------MTXTo
|-M---------M-B---------MTTE-?---o-MMX-ET--?XB-T---BMoMBE-?-B--T---TEXX---o------E-TB--T--|---|-MM-EB-------X--|---T?X-------?X--X------B--EE--TB-X-?M-----?-T------T-MB--XX----X-o-M---M----M-MB-T-E-o-
M-E------XB-M-----X?--|-o-TXXB-oM--E-?X--|B---M-M-T-|E?---|--BTMMo-TooXT--|--o----o---T|-XTTM?Mo||--B-oBB?-T------ME---T---?M--T-----o-M---B--M----M-M--?----Boo|-------E-o---?-E-oB-B-----?E--B----B?|M
T-X|--??BXE-B---M-To-----?------|----|------X-|E|---XT-BM--o--------EXo--o-?M---X?-M-E--M--XMM?|-o-|--o?---B-M-X--|-B?-------oEB-?M--B-M-T---EEo?M-o-----T-M-M--??oX---X--XE------T?|--M----E-E---EX-|To
ET?---o---?--o--M--ME----B|----o--B?MX?--E-T-X------|---MB----X-oBM-?-T--------MB--B?-ETM---Xo--X--?M--?-TE|-------TEEo-oo-?--TE--E--|E-|--B?M--XE--||-|-?-E-M-|-TTX-Mo-EM-----X-M?EX|E-----E|E----BEB-?
Eo-B---X--BE--T----E|--Bo--M---|--??-To---MT---BM-o-?--E|----X?B--|---B-?---oXMM-----------T---XE??---Bo-?--X-XM-ET-o--o--X-TT-?TB|----o----B|---M--BT|M--T--?B--|XBM--B-|--XX?BM---X-T-----X---BX---EMX
m-X--|-?--o-MBT?T-oo---E|oM-|M-?X--EM-------oXM----M---X-----T-oB----T|T-?-E---?EBM-B--XoB--|MM--T--?MB-o-o|--T?---M-M--T----X-Xo?---XM-------X--E-T-|T-----|-|BXEMM-E-T--E?|----MMo-M|E---To-T-|--BE-TE
XXXXXXXXXXXXXXXXXXXXXXXXXXXXXXXXXXXXXXXXXXXXXXXXXXXXXXXXXXXXXXXXXXXXXXXXXXXXXXXXXXXXXXXXXXXXXXXXXXXXXXXXXXXXXXXXXXXXXXXXXXXXXXXXXXXXXXXXXXXXXXXXXXXXXXXXXXXXXXXXXXXXXXXXXXXXXXXXXXXXXXXXXXXXXXXXXXXXXXXX
