-X--o------------XM-------------?--o----|--B--------------E---X--B--?---------?-----E------------M--|-Eo--o--------------------------EX-------?|-----M---oMX----------T--------------M-----T--------?|--
---X--M---o---E-------T---o-E----------?-B|-T---------B?--T----B----T--T----BX-o-----o-----M-oE-MM----E--|---?--|--------T--E------T-M---o-M----?--o--E--oE-----|--------X---------T--------X-o-E-o-X---
-----------EM-------?----------X------X----------------------|----M--E----X------o-----E--T--|o---|------o--B------ET--|----E---?---|--------X------MX--B-------------oB--------|M--M-----M-------------
------E----oX-----E-M-E-----------------T-----o--E--oM--TT--X--X---T-----------|-----Bo----|-----M-----T--Bo?--M-?------------------o---?-----M-oX----------M-T-------o----|-M------o|---o-----|--E-----
-Bo----XM-|?--------??----E---T--XB----------E--XT--o--M-X-----T--------------B-------?B----E--X--E--X?--X--E-M-T-E-------B|-----------------MX--E-E-oX---oE---E-Xo-----------T---M---Bo----------------
--------B---X--B--B----?---------------o-?--o-------M?-------?--o--------M---?o----oo------?------E---|---------------o------|------------?----XXM-ET---------------MT-|-----------------M----E-|--T----
----------X----|-o-X---E---M-MX--------E--X----B----------?E----o-|--T-------E----BB-------E--o-?---------E---T---o------------B--|----o----------o----------T----------X--TB----------------|M---B---|-
---------------|-B--Eo---------E--M---E--o-o----------------M----X---------------M-TE---E----|---o----?------Eo------------E------------o--o----X-------?----o-|-o-X--oE----------o---T-X------B-------v
--TB-E-o------E----B---o-------E---------M-----?-M------|--------oE-------------------?---|--|?-E----B-To|-------X------?|E---------|------oM---?M-------To---------M----|-----------?---X-|--M--------f
---------|?E--M----o---E--E------------o--X-----?-ME-------------X--------------BT--------M-B--o----E--------E-------?-o----------M---o|XB-|--?----o-E---|-------E---?---|-E--T--T------?--?--M-----|--f
-------?--M-o--T------o-------B--M||M|---------B-E-?--o----------M-?------M------X---o-----|-----------------E-----E--o---B----------X-------B-----E----o-----o--T------Bo-----------T-X----|---------?f
-M-E-E--------------------X|-M--------BE?------M|---E-------o--M|-------o-|----o----oM------E----M--X|--BM-E-BM----?-----M-------?-----T--BB-----o--oB------B-----|---E---?---B-T------------|B-----o--f
--B------X-----X-----------B-----B--E---X-------?-------o---X----E---------B-----|----X----X---M---B--------------Xo-----B----------E------------M----o-o--|--|---o--|E--------------X--T-B--o|-?------f
--M----|--M-|---E--BX--?--T---|E-----X-?--X-oE-----o---------M---M|-E-----E-M-----T-------------BT--------E----T--X----MX----X-----o-------X--|------X---------?----B-----------M?--------B-T--B-----M-f
m-X-------BT----------o---------?--------EBT----------T--o-------|----E-----------B---------X----------------|---MB--B---oX-----o---E?------B-?----?---------oX-T-------T--------T------|-BB---|-M--o--X
XXXXXXXXXXXXXXXXXXXXXXXXXXXXXXXXXXXXXXXXXXXXXXXXXXXXXXXXXXXXXXXXXXXXXXXXXXXXXXXXXXXXXXXXXXXXXXXXXXXXXXXXXXXXXXXXXXXXXXXXXXXXXXXXXXXXXXXXXXXXXXXXXXXXXXXXXXXXXXXXXXXXXXXXXXXXXXXXXXXXXXXXXXXXXXXXXXXXXXXX
