----o-M-M--M|-----M--B--M-B--o-----o----|-oBE------X---o--E----|-B------?-----?----?E------|?-----M----o----------T-----X------------E--|----o---------B-oM-----------T-------X----E--EM-------|----?---
---X--M------X---------------M-----------B--T----X----B---T-T-----------X-----o--------------oE----|-BEB-|---?B---?------T-----EE|-T-M-T-o------?--o--E--oE--E---------BE-------E----M--M-----oX--o--E--
------------M----M----B-----------?---X------------M---------|M---M---T|---------o-B---E-----|o--------|-o-XB---?M-----|-M|-----?-----X------------B-----T------------oB---------M--M-------------------
-o-------B-oX---------EX----oM---------------Mo--E---M-------------T----|-------?----B-----|-o---M--------B----------E----?-------T-o---?-----M-o-o-----------T-o--E--o------M-M--o-------T--|-|--------
-B------M-|?M----X---?---E-M--TM---?---T-----E---T-o---M-------T-------M-------T------?-----E----------X|---E-----Eo--E-?-B|--------E------??--M---E?oX--------E-Xo---------------M----o--o---B-M----E--
--------B---X-EB-TB----------oEo------o---X--------------T---------?o-E-B--X---E---oo---------E---E----------------??-o----|T-------------?--T--XM-ET------BT-----o-M--|---------?--X--------M-M|--T----
------X---X----|-------------MX?-------E--X|B--B---B------?---E------T--|M--------B--|-T---E----?o----------------o-------M----B-o|-?-o-----M------Mo?---------------------T-------------XT-E-Mo--B-|---
--------------------E------B------Moo-E--o-o-------------?--M----XET------T--o---M--E---EB----E---o-B--------Eo-----T--M------|-----------------X---T---?----o-|-------E----o---B-o?--T----------------v
-----E-o-o--|-E-----o---E-M----------X-------o-------------------oE---------------E-o-?---|---?--?-----T-|-------X-------|E-ToX-o-------?-Eo------------X------o?--?---|-|------M----?----------|------f
------------X-M---------T-E------------o----E-|T?-M----|--|---??-X----------o--B-T----M---M--MX--T---------------B----------------M--M-|X--|-------o------T--E-----------|----To-T-|----?--?-XM--T-----f
--EB---?----o-------?oo----------M||M------?---B----B-o-o-----T--M-------|-------X---oXo--|--------------?----B-----MXo--M--------M------?---BT----E----o-E--Eo--T---M---o----?---B---------|------?E-?f
---E-E--------MX-M---------|-----M----B--o---o------------E-o--M---------------o------X-TT---?---M------BM-E|-M----?------------X-B------|---------------E-------?------------B-------|----X-|---------f
------T--X---------o-B-----B--------E-------B--M--------oM--X----E---|-----B-----|----X-E------MBTE------X--B-----Xo-------------E--E------B-----M--o-----?---|---o---E---------M-|-----T-B-----?------f
--M---M|----|------BX----------E--E--X-?--X-o-X-o--o-|E-----?--B-M--E---?-E-M-------o-------------------M?--?|-T-----E--X----X-----o-------X--|----T-----------?-------B-----X---?-----T-------B--M--M-f
m-X----------|B------------M-------------E-----M------T?----------T--XE-----|-----B-T------------------------|---MB------o-E--X-o---E------|B------?-------X---------|---Xo--?---T------|-BBM--|----o--X
XXXXXXXXXXXXXXXXXXXXXXXXXXXXXXXXXXXXXXXXXXXXXXXXXXXXXXXXXXXXXXXXXXXXXXXXXXXXXXXXXXXXXXXXXXXXXXXXXXXXXXXXXXXXXXXXXXXXXXXXXXXXXXXXXXXXXXXXXXXXXXXXXXXXXXXXXXXXXXXXXXXXXXXXXXXXXXXXXXXXXXXXXXXXXXXXXXXXXXXX
