--------------------------------------------------------------------------------------------------------------------------------------------------------------------------------------------------------
--------------------------------------------------------------------------------------------------------------------------------------------------------------------------------------------------------
--------------------------------------------------------------------------------------------------------------------------------------------------------------------------------------------------------
-----------------------------------?--------------------------------------------------------------------------------------------------------------------------------------------------------------------
----------------------------------------------------------------------------------------------------------------------------X-----------------------------------------------------------------------BBB-
------------------------------------------------------------------X--------------------------------------------------------XX---------------------------------------------------------------------------
-----------------------------------------------------------------XX-------------------------------------------------------XXX---------------------------------------------------------------------------
----------------------------------------------------------------XXX------------------------------------------------------XXXX--------------------------------------------------------------------------v
---------------------------------------------------------------XXXX-----------------------------------------------------XXXXX--------------------------------------------------------------------------f
---------------------------------------------X----------------XXXXX----------------------------------------------------XXXXXX--------------------------------------------------------------------------f
--------------------------------------------XX---------------XXXXXX---------------------------------------------------XXXXXXX-----------------------------------------------------o--------------------f
-------------------------------------------XXX--------------XXXXXXX--------------------------------------------------XXXXXXXX--------------------------------------------------------------------------f
------------------------------------------XXXX-------------XXXXXXXX-------------------------------T-----------------XXXXXXXXX-------------------------------------------------------B------------------f
-----------------------------------------XXXXX------------XXXXXXXXX-------------------------------|----------------XXXXXXXXXX--------------------------------------------------------------------------f
m---------------------------------------XXXXXX-----------XXXXXXXXXX-------------------------------|-------------E-XXXXXXXXXXX----------------------E---------------------------E-----------------------X
XXXXXXXXXXXXXXXXXXXXXXXXXXXXXXXXXXXXXXXXXXXXXXXXXXXXXXXXXXXXXXXXXXX-XXXXXXXXXXXXXXXXXXXXXXXXXXXXXX|XXXXXXXXXXXXXXXXXXXXXXXXXXXXXXXXXXBXXXXXXXXXXXXXXXXXXXX-XXXXXXXXXXXXXXXXXXXXXXXXXXXXXXXXXXXXXXXXXXXXX
