----------------------------------------------------------------------------------------------------------?????-----------------------------------------------------------------------------------------
--------------------------------------------------------------------------------------------------------------------------------------------------------------------------------------------------------
-----------------------------------------------------------------B--------------------------------------------------------------------------------X-----------------------------------------------------
------B-------------------------------------------------------------------------------------------------------------------------------------------------------------------------------------------------
----------------------------------------------------------------------------------------------------------------------------X--------B--X---------------------------------------------------------------
------------------------------------------------------------------X--------------------------------------------------------XX----------XX---------------------------------------------------------------
-----------------------------------------------------------------XX-------------------------------------------------------XXX---------XXX---------------------------------------------------------------
----------------------------------------------------------------XXX------------------------------------------------------XXXX--------XXXX--------------------------------------------------------------v
---------------------------------------------------------------XXXX-----------------------------------------------------XXXXX-------XXXXX--------------------------------------------------------------f
--------------------------------------------------------------XXXXX-----X----------------------------------------------XXXXXX------XXXXXX--------------------------------------------------------------f
-------------------------------------------------------------XXXXXX----XX---------------------------------------------XXXXXXX-----XXXXXXX--------------------------------------------------------------f
------------------------------------------------------------XXXXXXX---XXX--------------------------------------------XXXXXXXX----XXXXXXXX-----------------------B--------------------------------------f
-----------------------------------------------------------XXXXXXXX--XXXX-------------------------T-----------------XXXXXXXXX---XXXXXXXXX--------------------------------------------------------------f
-----------------------o----------------------------------XXXXXXXXX-XXXXX-------------------------|----------------XXXXXXXXXX--XXXXXXXXXX--------------------------------------------------------------f
m--------------------------------------------------------XXXXXXXXXXXXXXXX-------------------------|---------------XXXXXXXXXXX-XXXXXXXXXXX--------------------------------------------------------------X
XXXXXXXXXXXXXXXXXXXXXXXXXXXXXXXXXXXXXXXXXXXXXXXXXXXXXoXXXXXXXXXXXXXXXXXXXXXXXXXXXXXXXXXXXXXXXXXXXX|XXX-XXXXXXXXXXXXXXXXXXXXXXXXXXXXXXXXXXXXXXXXXXXXXXXXXXXXXXXXXXXXXXXXXXXXXXXXXXXXXXXXXXXXXXXXXXX-XXXXX
