--?M--o-X----X|----To---M?-E-EXM--T--MoT--B---o--X---E-B-B-XE--oB?--E-o-?---?o|-?--|X--B-|-----M--T-M---XXX---E---o-|o-B--T-B--|TX----T-BB---------E--|-EM|--?EE?-|M?|?M-o|oB----X-----T-----M||--?XXX--
--|---X-|B----M------o---|Bo--X-----E----?-M-|ToX--B----Mo-----?--M-M-TM-o----o------MoX---MX--Bo---M-M---ME-----T---M------BE---oMoE-T----T---M|-EM-B?----To-----o--o----o---|--B-E-E-E---??---------?-
-M-Bo-M----M--|--|E----E-EMT?---Eo--EE---|--?-----oT---T---M-E--E-TT||B--?--X-M---X-EM|-|-M--------|-EM-XB------T-T-|?|M--X--X-XB?X-M--o-M-----X-BTE-----E--B-MMX----B-----?-ME---EM---X----EM|---T-E-X-
-M--M-Mo|B---|-----o-EM-----T-E--M?-X?--o---T-B--M--||-MXX--M-oT--B--o--E----o-M|-EM-----T|o-?--TM------TEMBT-M-E--oEX---M---T--------o--|-------MT--oX-E-E-|----X-E|-B---E--X-oB-EET--MTo-E-|-o--o-|---
-M-T--TB---ME-X?--Xoo|--E|T-o-----T---T--M---B-XoB---X----|?B-----XoM---MX-----?T-|-?-------X--E?--BBMT--?Eo|E-----?-|----XBT---?E-T-XE--BMEoooX-XM-?---ToE--MM----B---|o-Eo-?--EX--EEBM|B---?----B---T-
---|-|?|-B---oo-M--EoM---?----T--o------|M-M----M----oM-oMM|-?--B----?--o---------B----T-M----EX--?---o-----M-?--MBM?-ET---XBXX--oE---???--T?--XT|----|--?--BM----EXM|--M-?E?T---E------M---?o--?-------
--?X--M--|-T----TX----B-B---X---T-B----B--MTM-E---o-o----?-E---E-Xo--|-E----E-?M--||---M-------B---|--|-EoE-M-?-?-|MM-Eo-ET-E--B------EMT-M-B---|--------?-B|-M-o-M?---E-|Bo---|?X-TM-EE-----TXE--|-----
--|--|?BooX-EMM--XT-----o-XoT----o-?----XM?--X-?-ooX----o-E?XT---MXMo-XM-----T---T----TM-----B--MM----Xo----M----XB---XE?----E---E-----|M-TX-||-?-----X--T-T-?E----------------EE--o---E-To--T|--?----Mv
-o-Mo-oE---E--EM|?---E-o-E---?|XT-T?--oXM--M-M-o--X-B------TT?-BE---?o---MBTMME-EMXX--?-E---o------TX--o--??T------TMMM-------?E-----BME-oo|------|-B-M----|---X--BoEBM-------?-??--B--B----B?-B-----MBf
---o-ET|-X-oT--o--|-B--T---M---oTo-TMX-o-TEo--XE-M-------|o--o--T??----o---B|---E-?E-o---?----Eo--XM?-||-------X------|-----TM-?-o-o-MB-X-T--|M-E--M--?T--|-----T----TM-----------TEB--?B-M---?----B|--f
-o-B-o-E--X-?-o-E|--X---M--E----X-|BE--?T---B-----X-o-B|TM-?------oM?TMT-XE--|--?M--oM--o--o---XM----X------?-M-----o--|-X-?|--?-?-----X----M-Eo-|?--B---X?oMM--B-E--E-EM-oM-B--oX-X--oX|o?TB--M----oEof
--MT-MEo-----TMT-|-|-?X-?----MM-----|EM?-o-|--M--ooM-?M-E?----o|?B-oT--|X-o--o-|--X------MM-|-?--B-----E---MoooE-Eo-o-----M-----TE--M-||M--E-T--?-BB---M--EoXo---TB-BX--BMX|M--T-E----M?-E-T-T--Bo-EB--f
-MM------M--XMBXEoBT-o---------X?-----T--BEX--|--M--E-T-X--B----o-----|-E-XEE?E---|-?E-o-B--Bo-T--To---|-----TET-oE-?-oBEB--T?-T--|-oXo---E-|T---B-TE-X?o-BTB--X---B-------M-|--X-BE|--T-?----E-?MTM--Tf
------E-M-oX|---B-ooBoT--MoBTM-B----o---EEo|-o-?------BEBX--MT---T-||T-EoTM-?------M-B--|---o--E------B-B---E--X--------oo---ooBB-To-M---T|B|B--Eo||-|---BB--Mo--ME---B--M---EE|X---MM|---XXB--?--|---Tf
mB---oEX---|----T-??-X|---Mo--To-B-XT----EB-oo-B-o|oM-M--T----BT---E-----M-E--E--T--MTT-M-M-----BM-T---|--oB-EX--oB||-XXo-?oXXME---|oM?oo-?T--MTXE-T----T--X---M-oM---?---T------X-MBX-?EoT---E?--B-BX-X
XXXXXXXXXXXXXXXXXXXXXXXXXXXXXXXXXXXXXXXXXXXXXXXXXXXXXXXXXXXXXXXXXXXXXXXXXXXXXXXXXXXXXXXXXXXXXXXXXXXXXXXXXXXXXXXXXXXXXXXXXXXXXXXXXXXXXXXXXXXXXXXXXXXXXXXXXXXXXXXXXXXXXXXXXXXXXXXXXXXXXXXXXXXXXXXXXXXXXXXX
