--------------------------------------------------------------------------------------------------------------------------------------------------------------------------------------------------------
--------------------------------------------------------------------------------------------------------------------------------------------------------------------------------------------------------
-----------------------------------------------------------------------------------------------------------------------------------------------------------------------------B--------------------------
--------------------------------------------------------------------------------------------------------------------------------------------------------------------------------------------------------
---------------------------------------------------------------------------------------------------------?------X---------------------------------------------------------------------------------------
-------------------------------------------------------------------------------???????-------------------------XX--------------X------------------------------------------------------------------------
----------------------------------------------------------------------X---------------------------------------XXX---------------------------------------------------------------------------------------
-------------------M-------------------------------------------------XX---------------------------------X----XXXX--------------------------------------------------------------------------------------v
-----------------------------?--------------------------------------XXX--------------------------------XX---XXXXX----------X-------------------------------?---------?---------------------------------f
-------------------------------------------------------------------XXXX-------------------------------XXX--XXXXXX---------XX---------------------------------------------------------------------------f
------------------------------------------------------------------XXXXX------------------------------XXXX-XXXXXXX--------XXX---------------------------------------------------------------------------f
------------------------------------------------------X----------XXXXXX-----------------------------XXXXXXXXXXXXX-------XXXX------------------------------------------T--------------------------------f
---------T--------------------XXXXXX----------------------------XXXXXXX----------------------------XXXXXXXXXXXXXX------XXXXX--------------------X---------------------|--------------------------------f
---------|-----------------------------------------------------XXXXXXXX-----------------------M---XXXXXXXXXXXXXXX-----XXXXXX--------------------XX--------------------|--------------------------------f
m--------|------------------------------------------E---------XXXXXXXXX--------------------------XXXXXXXXXXXXXXXX----XXXXXXX-----E--------------XXX--E----------------|----E---------------------------X
X----XXXX|XXXXXXXXXXXXXXXXXXXXXXXXXXXXXXXXXXXXXXXXXXXXX------XXXXXXXXXXXXXXXXXXXXXX-----XXXXXXXXXXXXXXXXXXXXXXXXXXXXXXXXXXXXXXXXX----XXXXXXXXXXXXXXXXXXXXXXXXXXXXXXXXX|XXXXXXXXXXXXXXXXXXXXXXXXXXXXXXXXX
