--------------------------------------------------------------------------------------------------------------------------------------------------------------------------------------------------------
------------------------------------------------------------------------------?-------------------------------------------------------------------------------------------------------------------------
-----------------------------------------------------------------------------------------------------------------------M--------------------------------------------------------------------------------
--------------------------------------------------------------------------------------------------------------------------------------------------------------------------------------------------------
----------------------------------------------------------------------------------------------------------------------------X---------------------------------------------------------------------------
----------------------------------------------------X-------------X--------------------------------------------------------XX--------------------------------------X------------------------------------
-----------------------------------------B-----------------------XX-------------------------------------------------------XXX-------------------------------------XX------------------------------------
----------------------------------------------------------------XXX------------------------------------------------------XXXX------------------------------------XXX-----------------------------------v
---------------------------------------------------------------XXXX-----------------------------------------------------XXXXX-----------------------------------XXXX-----------------------------------f
--------------------------------------------------------------XXXXX----------------------------------------------------XXXXXX----------------------------------XXXXX-----------------------------------f
-------------------------------------------------------------XXXXXX---------------------------------------------------XXXXXXX---------------------------------XXXXXX-----------------------------------f
------------------------------------------------------------XXXXXXX--------------------------------------------------XXXXXXXX--------------------------------XXXXXXX-----------------------------------f
-----------------------------------X-----------------------XXXXXXXX-------------------------------T-----------------XXXXXXXXX-------------------------------XXXXXXXX-----------------------------------f
----------------------------------XX----------------------XXXXXXXXX-------------------------------|----------------XXXXXXXXXX------------------------------XXXXXXXXX-----------------------------------f
m--------------------------------XXX---------------------XXXXXXXXXX-------------------------------|---------------XXXXXXXXXXX-----------------------------XXXXXXXXXX-----------------------------------X
XXXXXXXXXXXX-XXXXXXXXX--------XXXXXXXXXXXXXXXXXXXXXXXXXXXXXXXXXXXXXXXXXXXXXXXXXXXXXXXXXXXXXXXXXXXX|XXXXXXXXXXXXXXXXXXXXXXXXXXXXXXXXXXXXXXXXXXXXXXXXXXXXXXXXXXXXXXXXXXXXXXXXXXXXXXXXXXXXXXXXXXXXX---XXXXX
