-X---MM-----------------MEB--------o---------------X-------B------------------?|E|-?-------------M----E--To-----B-----------------------|--X--?---?---o--oM-----o-------T------X-----M-M------------?|--
---X----------E----o--T------M---E-----?--|------X--------T----BM---TT-------------XEo-------oE-------E---------------o--T--E--EE|-----T-o-M-------o--E--oE-------------------E--------o----X-----o|----
-----------EM---------B--------X-----------M------------|------B--M---T---------Bo-B----|----|----|M-----o-------------|--------?XT-|--------X-------X-----------|----oB--------|-o-M-----MB------------
---------B--X---?----oEX--------------?-TX---M---E--oM--TT--X------------E-----|------o----|-o---M--B-M----o?---o?------------------oM----------------B-------T-o-----o----|-M-----Eo----o-----|--------
-Bo--M--M-|?-----X?o-?------X-T----?---T-----------o-----------T-|o----M----E---------?B----E-----E-----|X--E-M----oT-E---B|--------E-------?M-M--B--o-T--oE------o---------------M--BBo-------------E--
-X-----?----X--------E-?B------o---------?XM--------M?---T------o|--o------XX--E------T--------E--E---|---------T----------|-|--E-----B-o-?----XXM---------BT----?--MT---------?-?-------M-|---M--------
------X|-------|-o----------TMX?------B--XX--------B--M----EM--------TT-|---------B-------ME---X?--------E--o-T------B-------E-B------------------oMo?-----B-----B--|---X---B------------X---|Mo--B-|---
--E--X----------------o--------E---oo----o-o-----------------------T----E--------M--E-------||E--o--B--------E------T--M------|----------------XX------o?---EoE-------oE----o---B--?--T-X------B?------v
-------o-----|-----B------M--------o--|T--EX-o----T--------------o-o---M------------o-?---|---?------B--o--------X----------T-------------Eo---T----E------------B-----|-||--o--M--X-?-----|----|------f
---E---------MM----o------E--X---?-----o-o----|--------|-o--?-------------------------------B--o--MB----------|------?-o?------------------|--?----o-E--X-TM-E---E------|-oE-ET--TE|--o---X?-XM--T--|--f
--------T-M-o-----------------B-M-||-------?--E-T-----o----------M-----?--M------X-M-o-o---|-BE---------o---------o-M-o-----------M--X--??T---T-E--E----o-----o--T------Bo---|---E---T-X-----To-o-----?f
-M-E-E--E---E---T-----------------------?------M------------o------|E----------oX---o---------E-----X------E|-M----------M-------?B-----------?---o------E----------o----B----BX-------B---X--B---o----f
--B------X--------Eo|B--------------E-------B---?--------M--------?--|---o-B-----------TE------M--E------X---T----X------B----------E--------------T--o----|--|----M-----T------M-|-------B---|--------f
--M---M---MT|-T-E--BX--?------|EE---XX-?--X-o---o-To--------?-----|-E-----E----?---|-E------------X--------?--T-M--B?--MX------------------X----?-E-?X--------E?----B-o-|-------M?o-B-------T--B-----M-f
m-X--------T-------B-------M----------Bo-------M------T?-------------X------------------M---X-------TX----|--|---MB--B---o------o----?--------?---o?-|-?--B--oX-T-T------X-----T-T--------BB---|-M-----X
XXXXXXXXXXXXXXXXXXXXXXXXXXXXXXXXXXXXXXXXXXXXXXXXXXXXXXXXXXXXXXXXXXXXXXXXXXXXXXXXXXXXXXXXXXXXXXXXXXXXXXXXXXXXXXXXXXXXXXXXXXXXXXXXXXXXXXXXXXXXXXXXXXXXXXXXXXXXXXXXXXXXXXXXXXXXXXXXXXXXXXXXXXXXXXXXXXXXXXXX
