E---E----|---M-?-|-oX-E-XEM-M--B-E|-E?|--M--TT--T-----------B?----MBoo--X--|---?---E-E---o-E-XE-E-?---X?-X--E|--o-E----XMT----|-o---TT-M-EX---------o?-M-MMX-----E---E-EX-?X--------X---|--E-T--?------X
B-o--Eo-o-----oo?--B---|--XB-XM---|-T--X--|--X--o----o-|--B-----|-To--M--o-----M-T|Bo-?----B--B------?M---T-?E--B---E-B--|E-----?-B-MB-T-|-B-oX-----E-?-------o?--X|EXE-M--B?-----T---|--?---E--EM--|-EM
EE--MB-BX?-E----?|--oE-???--B-X-X---E----B--EB-B-E-o-E-E----Eo------X---TX----X----B---|-?BEX-|-MB-MM-Xo-o-oo?E-?--B-XM-?---X--E---oo|-B|-EM--?o--T--?X----B-oBT|?TXM-M--o--|-----oE---MXMM---T------?o?
o--T-|o-X-oX----------M---MEo|-?EB-|----o--|-----B|-?|X-ETM|-ooME-To-o---T|-T-B-|?M-o------Mo--|--T|---B-?----XXo?TMoX-X---------ET-XB--o-?M|XX----------?-----oTM-------|-oT-B--B?------||-M-o---|?-|E-
|M?|-T--------?-|XM-|B-----o-----oE-|--M-MT-M----??M-----?T----E-T-??BBB-B-?------------E--?-|-?|-M--E--ToMX--|-----E|---E-?--M-?-E-M?|T-o|-EBTM--ME--E---MB--BX---Mo-T-XoX---|-X--B-?------B-?o?M--B-EM
o--E----M----XE------oB-o-MB-X---T----E--|--T-o-Mo---B--?o---|--E-?--XB-?--|o-M--B-M---BM--Eo|-M----?---o-MM---MM--o-Mo--o----o-------?----B--M|-|EMX----BX-B-----?---o--???o-oB-X-----?-o-o-T-E---o--|?
?-T--o---EM--o---|--X-X|-EB-Mo-|BTo|B-oXX-B-?|-?-oM-B|----------|M|------B-M-o--------E|EM--X--B-MM-BM?ME-----EBT----E-?|----M--?-M-B-XM--|oB-?--------|-T-|?oo--|E-XB--X---TX-??X-T------EEM?E|TM-TB--T
----T?--M-T--E---E-B-X---o?o--||----BMX|oMM-T-X|--|T|-oToM-B---?-oME---|||T------E---E?--o?-E-E---XTo-BMXB|-----XE-E-B-?-X--X|B----EXo---M--MB|--X--?o--TM-E---o--------M--M-|-?M---?T----E-?---Eo|BTB-v
?---T--T-?-X--M?-?--B---M-ToXEE-o-XM---Mo-?-o-X|TT-|E|BT-XE---?M-B|T---X-----E--X-B-TT--?-E------?--?----MT----?Bo-?M-BoTMoM-MEE-----?oBoEX-|--BBo-X?M---?---o---?--E--?-XE--M|M-Too-EX?-TT?T---M--M-XT?
-XM?o-----E-M-B---B--E--MTTE--X--X-MM---T--?-------oMoMBEE?-B-XT---TEXX--------E-X-EBM-E--|---|-M--E--------X--|----?X-------?X-B--o----B--EE--T--X-?------?-------|T-MM--XX-E----oE---------X--B-E-E-oX
-?E---M--?B-X-o---??--|-o--XX|-oM--E--?E-|E---M-M-T-|E?---TM--TMTB-|-?XT--|---?-X-oT---|-|--MBMo|-BBB-o?B?-T------MM---T---?M-ET-----oMM---B--o----M-MB----M-ooo|---B---|-o-o-?---oB-B----?TE---?---B-|-
XoM|--X?BX--E-----?oB----?--?E--T-|--|-E---T---ET-o-XT--M--o---------XoE-o-?M----?BMXBT-?-BXMM-|-o-|--oo--EM-M----|-B?M-|----oEB-?M--B-M-T-?-EEo-MBo------M--M--B?X----X--BE----B-X?E--M--T-E-E---XX-|T?
M-X?--o-|-?--oXMM--Mo----B|----o--B-MX?--EET-X-----||--|MB----X--BM---TB-------MB--M?-EX-T--Xo--E---T--?-TE|E-----T-E--|-o-?--TE-?E--|X|--TB?MM-EE--||-----E-MX|-TTX-M-oE---E--X-M---|?-----?|--E--X-o-?
-o-B---X------X--E-E|--B-M-T---|--?M|To---oT------o----o|Bo-MX---o----B-?----XMM---------|B----XEo?---oE-?-BX-?M-M-----o---?-T-ETo|----o--B--|---o--BT|M--T-X-B?-XXBM--B-|--XX?-?-E-X|B-o---?-E-BX---EMB
m----E-?--o-BBT?--o----X|-----M?X--EM-------MXM----M---X-----T-oBM?B-To--?---|-?-B--T---|BE-|M---?--?MB-o-o|MoM-|--M?o--T----X-X-?---XM---?-----ME-T--T-o---|-XMXEM--E-T--M?------Mo-M|E---To-TM---BE?T?
XXXXXXXXXXXXXXXXXXXXXXXXXXXXXXXXXXXXXXXXXXXXXXXXXXXXXXXXXXXXXXXXXXXXXXXXXXXXXXXXXXXXXXXXXXXXXXXXXXXXXXXXXXXXXXXXXXXXXXXXXXXXXXXXXXXXXXXXXXXXXXXXXXXXXXXXXXXXXXXXXXXXXXXXXXXXXXXXXXXXXXXXXXXXXXXXXXXXXXXX
