E---E?--?----M-----oX-E-XEM-M--B-E|-X-|--M--TT--T---M-------B?----MBoo-----|---?---E--B--o-E-XE-E-?-?-X--X--E|--o-EM---XMTo--X|-o---T--MXTX-------B-o?-M-MBXM----E-----EX-?X--------XMB-|--Eo?-??------X
B-o--Eo-o-----|o?---------XB-XM--X|-T--X--|--X--o----o-|--B-T--E?--o-o---o-----M-T|Bo-?----B--B---E--?M---T-?E--T---E-B--BE-----?MB-Mo-----B--------E-?B------o--MM-EXE-M---------T---|--?|--E--EM--|-BM
EE--MB-BX?-E----?---|E-X??--B-X-X---E-B--B--E--BB--o---EM---Eo----E-X--TTXT---E?||-X-T-|-?BEX---MT-TM-Xo-o-oo?E-?--BEX-E?o--X--E---Xo|-B|-EM------T--?X----B-o-T|MTXM-M--o--|------E----XMM---T----|-oo?
o-oT--o-?--X----------M---M-o----B-|----o--|-----B|-?|X--TM|--oME|Mo-o---T|M--B-|?M--------Mo--|--T--o-B-?-E--XXo?TMo--E---------TT-X---o-?-|XX----------?-----oTM---------oTTBT-B?------|--M-o---|?-|E-
|T?--T-----E--M-|?---B-----oX----oE-|----MT-M----o?-----o?T---?E---??B-B-B-?--------|---E--?----M|M--E---oMX--|-----E|?--E-?--M-?ME-M?|--o|-E-TM--M---E--------X---oo-T-XoX---|-X----?|--?--B-?o?M--B--M
o--E----M----XE?----Eo?Mo-MB-o---T------------o-Mo---BM-?o------E-?--XB-?-----M--------BM--Eo?-M---o?---o?MMo--M---o-M---o--oMo-----?-?----B--ME-|-oX----BX-------?---o--?o?o-oB?X-----?oo-o-T-E---o--|?
?-T--o---E---X---|--X-X|-|B-Mo-|-T-ET-oXT-B-?|-?-oB-BX----------|M|------B-M-oB-|?-T--E|E---TX-B-MM-TM--E-----EBT----E-?|----M--?-M-B-XM-o|o--o--------|-T-|?oo-X|E-XB--X--X-X-??X-T---E?--EM?E-BM--B--T
----T---X-T------E-B-X--Eo?o--B------?X|oMM-T--|--BTT-oTEM-----?-o-X---|||T------E---E?X-o--E-E---XTo-BMX-|-----XE---B-?-----|TM---MX----M---B|-|X--?o-|TM-----o-----------M-|--M-T-?T----E-?-M-Eo|B|B-v
?---T--T-?-X--M?-?--B---M--oXEE-o-XM---Mo-??o-X|TT-|E|BT|X---B?--B|----XME---ET---B-TT--?-E------?--?----MT-----B--?M-B-TMoM-MEE-----?|BoEX-|--BBo-M|M---?-o-o---?--MM-?-XE-TM-M-Too-E-??TToTX--M--M-XT?
--M-o----ME-M-B---B--E--MTTE-?---X-MM---T--?X------BMM-BEE?-B-XT---TEXX---------BE-EBM-E--|---|-MM---M------X--|---T?X---?---?X----o-------E--oT-BX-?------?----B--|T-MM--XX-E--E-oE----M----X----E-E-oX
-?E---M--?B-X-----??-E--o--XXB-oM--E--XE--E---M-M-T-|E?---TM--TMTo-To?XT--|---?---oT---|-oT--?Mo|-BBB-o?B?-T----B-MM------XoM--T--T--o-M---B--o--|-M-M-------ooo|-------|-o---?-E-oB-B-----TE---?-o-B?|-
XoM---X?BX--E-----?oB----?---E--|-|--|----MTX--ET-o-XT--M--o---------Xo--o-?-----?-MXET-?-BXMM?|-o-|--oo--EB-M----|--?--|----oEo-?M--B---T-?-EEo-M-o------MM-M--??-----X--BE------X?E--M--T-E-E------||?
M-X?T-o-|-?--o-MT---o-B--B|----o--B-MX?-EE-T-X----T-|?-|MB----X--BM---TB---X---MB--M?-EX-T--Xo--E---T?-?-TE|E-------E--|oM-?--TE-?E--BX-|-TB?M-?EE--||-----E-M-|-TTX-M-oEM--E--X-ME--|?-----E|-----XEB-?
-o-B---E--BE-oX---XE|--BoM-M---|--?M|To---oT---BM------E|Bo-MX--------B-?----XMM---------??----XEo?---oE-?-BX-XM-M-----o---?-T-ETB|----o-----|-T-o--?T|M--T---B?-XXBM--B-|--T-?-?-E-X|B-o---?---BX---EMB
m----E-?--o-MBT?T-o-E--E|??-|-M?X--EM----?--MXM----M---XE-E--T-oBM?E-To--------?-BM-B---|BE-|MM?X---?MB-o-o-M-T----M-o--T----X-Xo?---XM-------X--E-T--T-o---o-XMXEM--E-T--M?-----BMo-M|E-X-To-T----BE?T?
XXXXXXXXXXXXXXXXXXXXXXXXXXXXXXXXXXXXXXXXXXXXXXXXXXXXXXXXXXXXXXXXXXXXXXXXXXXXXXXXXXXXXXXXXXXXXXXXXXXXXXXXXXXXXXXXXXXXXXXXXXXXXXXXXXXXXXXXXXXXXXXXXXXXXXXXXXXXXXXXXXXXXXXXXXXXXXXXXXXXXXXXXXXXXXXXXXXXXXXX
