-|ooX-----------X-B----X------?----o-E----E-E---E---------M---|T--M-?--X---ME--------|------------|--X-B------o---------XB--B---?------o-o---oB--X----XM--------|-----X--o-B----MMo--------M--Eo--------
---------------E----M-----E?------E-------|-------M------BTX--------M--------X-o----T--XT-------XE---------M-|--B----M--------o---oX---XX--E---M-------M------o-----o----------|---|o-?-------------|---
-----X-T-|---?--|?--------o--E--M-M---T----?-oo--------|----------X-B--|T-M-TM--?--MX---EBo-------T----------|----M-B----E-?---------M--E?-----X-------?-E-------E|-|------------E-X------------------o-
---------o--|?----o-o-----?-----------?---X----|-B------------XB--?------------?MB-T-X-B-------------o-M------X---?|---B-----------|--------B-----B-X---B---------XB-------o--------X----E---------|M---
----T--M--------M---?M--------?-X--M-M---T---o---B------?--B-T------------M|B-M------------T-T----Mo-----o-------o-B-----XB-------|-|----T-------------X---o---?--T-----M------E?---------?E-M--------T-
--?---|---M------X----------o---X-----------------X-----T---M-oE-M----------o------?o----------T-----B------------B?---------------?----------|-?--EE----X------B-------X--------o--M-----X-----??E-o---
-----T-E------------M-MB-----|--E--------o--?-E------?--|------------------------?B?|-XM-------|M----T----?-MMX-------------?-----B-X-------M-X---E----EEE-?----M---o-----------B----Bo------T-B--------
--|---------?-------?----|-M---?|-----X----?-o--------MB-------T-----------BXB---oB--|--|--To--M-|-o------T|------ET--X--------------T----o----B----To----------MX--E-----------------B-------------M--v
----------------o---M------E-X---BB---|------EM-----E-o-|----------------o-----------------------------o-X-B----T?|-T------M---X----o-o-?---?--|B------|X------------oE--X-----E------E-?----?---?----Mf
------------M-o---------X---M--o-E-----M--|----?T---oE-X---X|-M----------o---?--o----------?-|----X-----B----X--|---T--TM---------o-----M------E-X---X-----M-----To-----T--------M---M|--B----B--------f
-MB--T----E--------o--oM-|--?--------?-E---T-M------E|---------o--T--X--||-B---?BM---X----?----------?B-oX|---B------T?-------?-?-X-|-----------E---------------?M--M-------?-----X------------E-------f
-----M--------oo---------M----------------B--M----o-?---B-o-|-E------o-|BX|-----B--------E?------?-MB----B-----B---------M-TT----M----T--------E-?-o-----TMX-X-T------M|-oT---T----o------B-X-------X--f
--E----|EB-B---------------------|----|----------E-------To---M--------BBE---|------E-----------XM--?-o--------?----------|-?--o----BM---o-M-------MM?E-E-------------oE-----|------------MX----B-M|-Bof
----E-----?----------?-----------------------T----E--------------o-----------------------o-----X----ME---M|X--T-E-B--------|--o----TMXo--------o---E------E----E--|E----|----------------oBT-B--o------f
m---EM-------?X-----Xo--------M------T--T--------B----------E-XE----E--Mo------EM--------?---o--M-------o--B--?-X--?--------------------Xo-------|-------------oo-E-E?--E----Bo-?B-E--M-------EXX-----TX
XXXXXXBXXX?XXXXXXXXXXXXXXXXXXXXXXXXX?XXXXXXXXXXXXXXXXXXXXXXXXXXXEXXXXXXXXXXXXXXXXoXMXXXXXX-MXXXXXXXXXXXXXBTXXXXoXXXXXXXXXoXXXXXXX-XXXXXM-XXXXXMXXXMXXXXXXXX|X|XXXXXXXXXXXXXoXXXXTXXXXXXXXXX-XXXXXXX-X-XX
