--------------------------------------------------------------------------------------------------------------------------------------------------------------------------------------------------------
-----------------------------------------B---------------------------------------------------------------?----------------------------------------------------------------------------------------------
----------------------------------------------------------------------------------------------------------------------------------------------------------X------------------B--------------------------
--------------------------------------------------------------------------------------------------------------------------------------------------------------------------------------------------------
---------------------------------------------------------------------------------------------------------?-----oX---------------------------------------------------------------------------------------
-------------------------------------------------------------------------------???????-------------------------XX--------------X------------------------------------------------------------------------
----------------------------------------------------------------------X-----------o---------------------------XXX-?-------------------------------------------------------------------------------------
-------------------M-------------------------------------------------XX-----------------------------B---X----XXXX--------------------------------------------------------------------------------------v
-----------------------------?--------------------------------------XXX--------------------------------XX---XXXXX----------X-------------------------------?------------------------?------------------f
-------------------------------------------------------------------XXXX-------------------------------XXX--XXXXXX---------XX---------------------------------------------------------------------------f
------------------------------------------------------------------XXXXX----XXXXX---------------------XXXX-XXXXXXX--------XXX---------------------------------------------------------------------------f
------------------------------------------------------X----------XXXXXX-----------------------------XXXXXXXXXXXXX-------XXXX------------------------------------------T--------------------------------f
---------T--------------------XXXXXX----------------------------XXXXXXX----------------------------XXXXXXXXXXXXXX------XXXXX--------------------X-----o---------------|------------------------------T-f
---------|-----------------------------------------------------XXXXXXXX-----------------------M---XXXXXXXXXXXXXXX-----XXXXXX--------------------XX--------------------|------------------------------|-f
m--------|---------------------X------------------------------XXXXXXXXX------------------------E-XXXXXXXXXXXXXXXX----XXXXXXX-----E--------------XXX--E---E------------|----E-------------------------|-X
X----XXXX|XXXXXXXXXXXXXXXXXXXXXXXXXXXXXXXXXXXXXXXXXXXXX---XXXXXXXXXXXXXXXXXXXXXXXXXXXXXXXXXXXXXXXXXXXXXXXXXXXXXXXXXXXXXXXXXXXXXXX----XXXXXXXXXXXXXXXXXXXXXXXXXXXXXXXXX|XXXXXXX----XXXXXXXXXXXXXXXXXXX|XX
