----E-EMT----MM-M|--X-E--EM-ME----|M-----o--T--oT-------oX--B---T--BoT--X--oE--?-?-E-B--Xo?E-XE-E-?------X--M---TBET---MM-o--X|-o---T--MX?X----M--BEo?--TMB-M--------E-----XB---T---XMB-|-|Eo?-----o----
--o--?oMo----------BX-----XB---MM---E--X--|-Xo-----E---E?--B----|--X-o---o---BMMB--XoX?|-----M-|-----?--?ET-?E--T?|-E-BB-|EM----|-B--BM----B--------E-o-----E-o--MX|EXEo----?-----T---|--?|-T-----T---B-
-E--MB-B-?XE-----|---EB??E---?-?-B--E----------Bo-To-E-Eo-X-Eo-E--ETXB-TTXT--MX----X---X-?-EX?|-MT-M---oB--ooTE----BEE--?----M-ET-oEo|-B--BM-o?o-----?X----B--BE|MT-MT---o--M?o----ET---EMMo--T-------o-
---T-oX-X-o--XX-----T-------o|?-EBo||---oE-|B----BE??MXM--MM--oM--Mo-oo--T-o----|?o-o---M---oT-|--T|-----oX---X-oM-BM--E---B-E--B-------o--M|X----M-----T---B--o|M-------|-----B-B-----T-||----M---?-|E-
-T?-----B-----MB|X-------?Bo--T|--Eo|-----T-M----o?M-----X-----E--?-BB-B-|BT--?--E-M-X-----T----o|-E-EB--o-B-----X|-E-?-|E--?--|X---M-----|BEBX-----------MX---X---Mo-T-XoX---E-X---M-|B-?--MM?--MXXB---
--EE----M-----E?-----oBMo-M--o--ET-------|--T?-?M-----------------?---?-E-E--MM--M-B---|M--E-?-X----o---E?-M--------B-o--o---Mo-X-B-?X?o---E--M--E-MX?o---------------o-Eoo-o-o??X----X?oo-o-T-E-M-o----
--T?-------------|-?-B-o-EB-Mo-|---|T-oB|-XE?|E?Mo-------||-----|M--X----BoM-T-X|-MTT-X-MM--X-MBXMEET-?--?----|BT---TE-?|-o-MM--?-MMB-XM-oBT--?-X-|----|-T-?-----|E|X--------X-X?X---M-E|EEEM?M-B--T----
-----?--M-M--ET--E-B-X|o---o-M--M----MX-oM----X---|T--oBE----|-?-o-E---|--TB---------E?--o?--------TToXM-T|-----XE---B---Xo-X-TX-----o--TM--MBM-----?-?|TM-E-X-oE----X--M--ME--|--TX|T|o--------Eo|BT-Ev
---E--MT--oXo-M?-?oET-E-M-To--E-o-XM--?-o---o-X|-T-|B|-T|X----?M-B|-E-o-M-T---------TT-XToE------?-B?----|T?T|--B-E?MEBoXMoM-MEE-----ToBo-?-|?--Bo-X----oE-o?----?-----T-T--TT?MBToo-EB??-To-------M--Tf
-XM---MM----M-----B|-E--M--E-----o?MoX-----?---T-oTBM--BEE?TB------T--X-B----B---X-EB--T------||M---T---M-X--M--|--T?MB--||M--X-BT-o----B---E--?--X-?M----??--------T-MM-X------X-oE----MM-T---XB-X-E-of
--?---M--?BBXMo-oBXE|E--oX--XB-M-----B-|-|---?-TM-TE?E--?-|----MMo-To-X---||o-----o----X-oT--?Mo|-B-B---B?--T---B---E--T---?---T-----o-MX?-B--E|T--M-M---M---o-M-M--B-B-|-o---?-E--B------B-E---?-XXT-|f
-oMTo-X?B-----|MM-To-B---?---E--|-T--|--?---X--E|o--TT-TM--o--|----|--o--o-TM----?-T|ET-?|BXMM?|-o||--|?-|-E-M-T-E|-----|----o---?MTT--X--B?--Eo-M--T-E----M-M--??|X---X--BE-oB-X-T?--T---T---E-o--X-|Mf
-M-?----|-?--o--M-BMo--|-B-----o--B-MX?-E----X-----|-?---BE---X--B--?-TB?----M-MB-XM?-ET----XoB-BT--T--M---|-X---B--E-o-oo-?-TTE-?E--oE-M--B?M--EE--|--|---E-M---TTX----EM-----X-MT-X|----ooE---o---EB-f
-o-----X--BEEoT-|-----TTo----o-|---M|To---oTo--BM-oo-o|--To----B-||B--B--|----MM-----------T---XE?----oE-?-BX-XM-MT?---o-o-?T--EEB---E-o-----E---o--BT|M--T---B?-B--X--B-|X?X-?-?-E-T-B-?---?---oX---E?f
m-X---o?--o-MBT---o-M--E|o?--MM----E---X----M-MB---M--|X--o--T--B-?E-T-|-?----??-BM-B|-X-BEB-MM-B?---M--ME?|M--o-----o|-E----T?-o?---E--M-----B--E-T?-T-ooo-|XXBXEM|-o-T-BM-E--o--E-TM|EX---B-T----BE?TX
XXXXXXXXXXXXXXXXXXXXXXXXXXXXXXXXXXXXXXXXXXXXXXXXXXXXXXXXXXXXXXXXXXXXXXXXXXXXXXXXXXXXXXXXXXXXXXXXXXXXXXXXXXXXXXXXXXXXXXXXXXXXXXXXXXXXXXXXXXXXXXXXXXXXXXXXXXXXXXXXXXXXXXXXXXXXXXXXXXXXXXXXXXXXXXXXXXXXXXXX
