--o---B----T-----EE-M|-----E-BXM-|--TME---|---oT-X-----BBBMoE--o-?-oE-o---o-?TT-M-----XB-X---M-M-M--M---XX|X--EBE-M-Mo-B----|---E-----T-B--X--o--|-|-E--TX---?E----MoB-M-E-o---oX-------Mo-E-T||-T--EX--
--|--|M-EE-E--Mo|--o-E-?--?-M----T--E-T|E----|TXX--B----M--X--M--B--M-TB-o-|-Bo----M-oM|---M----o---M?M---B------X---M------|E---Bo-T---E-TMT--M?---?-?-o-----|E-oo---------?--------EM-|--M-M----B-----
-M--o----T?---X--|B--M---E-B--X-Mo---oEo-B-|--?|-MoT----B|--|-----T-|MB----oXoM-|ooX-MX-Mo-E---|-BET--M-XM--T---T|-X|?oE--X--X-X--Xo---?--?Bo--X-BTE-T--M?--T-?------Bo-E--?-o|---EX-M-X---?--|-------o-
-TE--E-----E-|---E----M----BM-------T?--oBB-E-B---B-E--BXX--M-oT--B--B-B-----T-E|TEM----M?-o-?--------|T-XMoT--M----E---M----B--X------B-|X-T--?BME--EXM--|-|----oE--------T-X--B-EET--|--TE?--oE--|----
-M-T--TTX---o--?-X-Boo-M-|T-M----B---X-T-MB--X--?B|-BM?---|E--XX--Xo---M-----X-|B-B-?--X----|---?-T-|M----Eo-E-B-E--------MXo--X-|--B----BB?---E-----|M--XE---o---|B--o---M-o---E-XX---------?-BBX--To--
-X-|o-?-----Moo-M---E--M-M----T------B-E|M--X---------T--M-------T-M-?--EM-|------M-X----B--|---B|X---X-X---M--T-XTM?--o-X-?---M-oE---?B?---?--TTMBM-X----B-BT-T---XE--B-----TB---------M-M--oB-o--o?T--
--BX-----|-|----T-----o-B-XXXM-T--B?E--B--MT--MM?------BX?-------X--T-?XEXX---?--M-|--B-M------o--B-o-T-EoEX---E?--M-X|o-EB-E----------XT-MTX-MM--T-MB-Xo?EE-E--E?------E|M-T--o?--T??B-----EEX---M-?---
---MM|-BoM--EX---X-M?---o-XB---------EE-?----Xo--oo--M--o-EM-TT---X-B-XM-o--T----M---MoM-----B-?--EMB---|---?----o-MX-----------BEXTM------?o|T|?----T--------E-----------TT-o-|o----E---|--??B-----|T-v
-o--X-o-E----?o-M---X---M--M|?-X?------M--EM-M|---X--------T-EE-B--E?o-EE--T?MM-B------oE-EXM--M--EMM-E-?-??T---XM-TBEM-------?----|---E-TX|-M-?oM--X-MM-B?|---?--TBMB-|--BX--X-T?--o--B----Bo-----MEMBf
---o--o---?-T--M-------T--oM-T--E--?|-----?---E----BEB---|o----XTXo-B--X----||E---?-Bo-|-----E|--T-E--E-----E?---B----|---------Mo-o--B-XT|--|M|X----T----|-o----B--B-M---E--X--B-o-Bo--B--?---T--TB-T-f
---BM---------E-Eo--X---E--E-E--o-||--B-T|B------T---TE-oMTX--E-----T---------?-B---oE--o|-oMB-XM-B-----------X--B-X?|-|-XooMX-------BT---XB--E--MT-o--TEX-|M-M--B---E--E|oo-B--E--BM-T--o-?o-?M-E---E?f
--MTBMXo------M|-X---ME------METTE-M|--?BoM|--ME--T---M---E------T--XB--X-T--M--------------|E-------|-----oEE----o--M?-E?T---MM-EX-XT-|oMMX-T-----|-B?MXTE-BT--MT--BXM--MX|-T---|-EB--?-E--?TB-B--EE-Tf
---E-T--o--E-M-XB--T-oE--MM|E--BT--?--T---E---T--M--BMT-X--T-X-?oME--|E|---E--o----T---o--??Bo-EM--EE----E-o---TooEE?--o-E---BET----EM?--TE---X-Moo-EBX-X--o?|--|-?B---M|-EME---X--------?X-X-M-MXoo--Tf
----|---M-oB||--B-o-B-T---oB-E-BB--M----E-o|-o----TB-E-BMXo-M--o--|T|TT-o?--?-E--oo-----------M--?---M-T|---B---E-M-----BM|B-?-E--T-o--?-T|--M-E-----?-M-B--|M---M?E--BX-M--?|E|-?--?M|-MEXE---?ETBB--?f
mX--BBXX-----M----??-X||-MM-T-?--B-XTEE---B--B-BMo--M-M-BB-oM-B----?MX|X--|E?----ToTM-T---M---|-|T----------|-XE--BM|--To--XXXME---|-M??oT-E---TME-T---?T----X-M-oMX--Mo-BT------XMMMXo-EoT-B|EM--B-B-XX
XXXXXXXXXXXXXXXXXXXXXXXXXXXXXXXXXXXXXXXXXXXXXXXXXXXXXXXXXXXXXXXXXXXXXXXXXXXXXXXXXXXXXXXXXXXXXXXXXXXXXXXXXXXXXXXXXXXXXXXXXXXXXXXXXXXXXXXXXXXXXXXXXXXXXXXXXXXXXXXXXXXXXXXXXXXXXXXXXXXXXXXXXXXXXXXXXXXXXXXX
