----------------------------------------X---------------------------------------------------------------------------------------------------------------------------------------------------------------
-----------------------------------------B--------------------------------------------------------------------------------------------------------------------------------------------------------------
----------------------------------------------------------------------------------------------------------------------------------------------------------X------------------B--------------------------
---------------------------------???--------------------------------------------------------------------------------------------------------------------------------------------------------------------
---------------------------------------------------------------------------------------------------------?------X---------------------------------------------------------------------------------------
-------------------------------------------------------------------------------???M???-------------------------XX--------------X------------------------------------------------------------------------
----------------------------------------------------------------------X-----------o---------------------------XXX---------------------------------------------------------------------------------------
-------------------M----------------------M--------------------------XX---------------------------------X----XXXX--------------------------------------------------------------------------------------v
-----------------------------?--------------------------------------XXX------?-------------------------XX---XXXXX----------X-------------------------------?---------?---------------------------------f
-------------------------------------------------------------------XXXX------------B------------------XXX--XXXXXX---------XX---------------------------------------------------------------------------f
------------------------------------------------------------------XXXXX------------------------------XXXX-XXXXXXX--------XXX---------------------------------------------------------------------------f
------------------------------------------------------X----------XXXXXX-----------------------------XXXXXXXXXXXXX-------XXXX------------------------------------------T--------------------------------f
---------T--------------------XXXXXX----------------------------XXXXXXX----------------------------XXXXXXXXXXXXXX------XXXXX--------------------X-----o---------------|------------------------------T-f
---------|-----------------------------------------------------XXXXXXXX-----------------------M---XXXXXXXXXXXXXXX-----XXXXXX--------------------XX--------------------|------------------------------|-f
m--------|---------------------X--------------------E---------XXXXXXXXX------------E----------EE-XXXXXXXXXXXXXXXX----XXXXXXX-----E--------------XXX--E---E------------|----E-------------------------|-X
X----XXXX|XXXXXXXXXXXXXXXXXXXXXXXXXXXXXXXXXXXXXXXXXXXXX------XXXXXXXXXXXXXXXXXXXXXXXXXXXXXXXXXXXXXXXXXXXXXXXXXXXXXXXXXXXXXXX---------XXXXXXXXXXXXXXXXXXXXXXXXXXXXXXXXX|XXXXXXX----XXXXXXXXXXXXXXXXXXX|XX
