-----B-M?|------B|-oTM--XE-----B---ME----T--TB|o----|-E--X---?----MB----X--|-------E--o---M-EXE-E-?-------o-E|-?oB-----?M-o---M-o---E---B-o-----oT-Bo---M-BM-X--Xo-?-E--X--XB-------X-o-|--EoTM?--------
---X-E-?o----X|-?----o-|---B-XM--XX----X--|--M--o?-?---E-------------o-Eoo---o----|B----------B------?M--TT---?ET-?o---B-ME--|----B-Mo----o-----|--XB-?----X--o-E-M-EXE-?----o---XT----?-?|M----E-T---B-
----MBTBX--E----?---oE--??X-T-X?----E|---B-----BoM-o|E-|MXM-Eo----M----T-XX---X?M|-X--B|-?BE-X|M-ToM---B-o?--?--X--B-XM-?oM-X-XMT-ooo--BM|BM--MoM---X?X-|-EB-EBMEMT-M-M--o----E----E--|--MM-|-T---?---o-
-|-T-|o--B-X---?--?--EM-M-M-o-BXEB----X-o-X|-----o-|-MX-ET||-ooMEBMB-XX---X---B--?MBo---M--M--M|----o----o-E--XXoMTMo--X---o----BEToX-|-oo--|XXB--ET--o--?-----o|M----E--|-oX-B--------T-||---oM--|--|E-
-TT|-T-T---E--M--|---T---?-o------E---ME-M---------------?B----E---??X--EB-?--?--EX-|---E---?X--M|---EB-ToT-B-|-E----X?T-EMTM-M-?-|-M----o|B-o-M--M---EB----T-B---|---E-X-X---EBX-BMM?-?-?-EB-?oTM------
-M-----EM---oXE-----M?--X-MB-----T--M---X|--T-o-Mo-------o---|---o--B-B-o--|--M--------|M?oEo?-X-o------o?T--E|----o-ooM-oTo----X-X-M-?---E---M|-|-MX-o-?-----B---?---o--?--o-oE?X----XT-o-o-T-E-M-o--|-
--T--o------EX-X-|--Xo---E|-Mo-|B--EB-oX-E-E?--?BoB--X--?---B---|-|-------oM-oB-||----E------M-BX-M-T--MM-----|B--|-ME--|T---M--?-BMB|---o|o--?----M---X-|-??Xo--|E-XB--?-oX-X-X-----o--E----?E-T-?T--B-
-|--T|--MET-T------B-X-?---oEXB|-M--BMX-o-M-T-X|--|T--oT-E--E|--BoME|M-|||T-TX--M?---E?--o----ETETXTT----B||-MT-X?---B----o-X-----oMX---TM--MB|--EB|To-|-M----Mo----MM-oM----|X?M-T-------E--BM-Eo-B-B-v
---E---E--oX---E-?--BX--MBT-?-Eoo-EM--?-o||---X|-T-|E|-T-X---B|M-B|To---oE-?------BXT---?--EBB------?-?--MT----?B--?-MBo--MT-MEo--E--?-BE----?--Eo-M|M---E-oT----B--MM-E|T---MMM|----E-??oTo----M-M-TXMf
-BX---B----BM-?---B--E---TTE-?M--o-EMX-MT--?X--T----MoM|EE?EB--T--|T-B-----B--B--E--B?-E-T|-o-|--M-E----?------|---T?M-------?--B--oE-----E-M|----X-?M-M---?--XX----T-|T-XXX---M--oE----M--E-X--B|E-E-Mf
--E?-TMo-?BB--o-X-X--E|-o-EBTB-oM--E--X--|E-T---M---|E?---|MM--MMo-T--XTX-?---?---o----|-o--M?Mo|XB-B-o?-T?--|--?--E-o-T-EBMM--T-----MMM-?-B----TE---M-o-T---ooo|-T-----|-oT--B-T----T-----?-------o--|f
---|--E?B------B---M??-------E|---T-||---B-TXT-T|--ETT--M--o--------EXo--o--M---|?X--ETM?T|XMo?|-o||E-o-B--B-BT--E---?--|--B-o-B--M--B-M-TB--EE--M-o------X|XB--??-X---o?----o-M---oET-M----B?ET--XMM||f
---?--o-|--B---BMT-Moo|--o|X---?-BBTMX?--EB--X------|---MB--BBX--B-------X-M----B---|--o-T--X|--E----???-TE|E---------o--o-?--T------|E-E-T--M---E-o|--|---E-M---ToX-M--EM---T---ME--|-X-M--E?-----XXBXf
-ET?-------E-oT----ET--ToMM--?-|-X?M|TX---oTE-----E----o|-o---XB--|---B----|-XM|---------??----XE??B--oM-?-BXE?M-M-M?--o---?TT-ETBM----o-----|---o--ET----T---BX-|XBM-|T-|-XXX?---EEo-BMB---X---MX---E?f
m----T-?--o-MBT-T-o----E|-M-|MM?X?--M-o----o|-M---E----M-------XB-TE--o|-?---|?M--M-M-XXoBE-|MM--T-T?-B-oXo---M?-E-M?o--T---?X-Xo----XM------BB-EE-?--T|----|-----M--E-T-----?--oBM-TM|E---T--To---B-?TX
XXXXXXXXXXXXXXXXXXXXXXXXXXXXXXXXXXXXXXXXXXXXXXXXXXXXXXXXXXXXXXXXXXXXXXXXXXXXXXXXXXXXXXXXXXXXXXXXXXXXXXXXXXXXXXXXXXXXXXXXXXXXXXXXXXXXXXXXXXXXXXXXXXXXXXXXXXXXXXXXXXXXXXXXXXXXXXXXXXXXXXXXXXXXXXXXXXXXXXXX
