-X--o-------|---XXM-------B-----?--o----|-oBE-------------E------B------------?----?--B----------M----Eo--o-----B--------------------EX----X---|---T---B-o---X--------T------------E-MEM---T--------?---
---X--M-------E-------T---o--M---------?--|-T---------B?--T----B----T--T-----X-o-----o-----M-oE-------EB-----?-----------------E-|-T-M---o-M----?--o--E--oE-------------E--------------o------o--Mo-X---
-----------EM------------------X------X-----------------|----|-B--M--E----X--------B---------|----|------o--B------E---|----E---?-TT|---?----X------M---B-------------oB--------|M--M-----M-------------
------E----oX-----E-M-E-------------M--------Mo--E---M--TT--X--X---------------|?---|Bo----|-----M-----T--Bo?----?------------------o---?-----M-oXo---------M-T-------o----|-M------o|-------|-|--E-----
-B--------|?--E------?----EMX-T--XB?---------E------o----X-----T---?---M------B------??B----E--X------?X-X--E---T-Eo--E----|---------------?-MXMBE-E--XT--oE---EoX------------T---M---Bo----------------
--M-----B---X-----B----?B--------------o-?-----------?-------?--o|----E--M---?-----oo-T----?------E---|----------------------|----------o-?----XXM-ET-------T------TMT-|------------X----M----E----T----
------X---X----|---X---E----TMX?-------E----B--B----------?E--E-o----T--|---------B-------------?o-----T--E-o-T---o----------E----|-?--o---------Mo----?---------B--|---X--TB--------o-X-X--E-M--oB-----
--------------------E----------E--M---E--o------------------M----X-T-------------M-TE---EB----E------------E-Eo-----T--M----------M------------XX-------?---Eo-|---X---E----------o?--T--------B-------v
---B---o------E--------o-------E------|--M-------M-----T---------o-----M------X-------?---|---?----|-B-T-|-------Xo------|----------------EoM----M-------To-------M?---|-|---------X-?-----|--M-|------f
-T--------?EX-M----o------E------------o--------?---------|------X--------------B-----------B--o----E----------------?-o-----------o--o|XB-|-X?----o----X----E--ME--E----|-E--T--TE-----?--?--M-----|--f
-------?--M-o--T--------M-------M-||M---B--?-----E-?--o----------M--------M------X---oXo-M-|----o-------o-B---B----E--oT--B----------X------T-T----E----o-----o--T---M--Bo---|-------T-X----|-o-------?f
-M-E-E-|-------------------|-MX---------?----o------E-------o-------E-----|M---o----oM---T--E----M--X---BM-E--M----?-----M-----------?---|BB--------oB------B-----|-------?----------------X-----------f
--B------X-----X----|----------------------o---M?-----------X----E---------B-----|----X----X---M---B---------T-----o--E--B---E-----TE------------M----o-o--|---------|E-----------|-------BX-o|-?------f
--M-------M-|---E--BX-----T---|E-----X-?--X-o-X----o-------------M|-E-----E-M--?--T-------------BTX--|----E--------B---MX----X-----o-------X--|------X--------E-----------------M?o-B-----B-T--B-----M-f
m-X-------BT----------o--------o?------ooEBT----------T--o-----------XE-----|-----B---------X--------X-----|-|---MB--B--|o------o---E?-----------------------o--T-T--------------T------|-BB---|-M-T---X
XXXXXXXXXXXXXXXXXXXXXXXXXXXXXXXXXXXXXXXXXXXXXXXXXXXXXXXXXXXXXXXXXXXXXXXXXXXXXXXXXXXXXXXXXXXXXXXXXXXXXXXXXXXXXXXXXXXXXXXXXXXXXXXXXXXXXXXXXXXXXXXXXXXXXXXXXXXXXXXXXXXXXXXXXXXXXXXXXXXXXXXXXXXXXXXXXXXXXXXX
