---o---E--B------------M-M--B-------MX--------B-o----------------|M--MX----?-E----------------B-B----?----------E-----X----o----|?o-----M-----------E-|----M------?|---|---------------o---o---X---E----
-?-?------------TBB-E?-----B--M-----E-------------------T-----------To-----B-----B------?-------B-M-------------E-----X-oX----T----?---X---M---B--?-----X--------?--E-T--X?------B|--X--|-----B-MX------
--X---T----M---------------BT-o---E--------M|----M------|--B--|------------M-----|--E--M-------------|---X--M--?----o-BE?----X-E----XB--------|T--EB------------XX-----oM------B-------T-M----B---------
---o?-T-----E------|?---E-----|---o---E-------------X|-------------?---X----------E------------|-T----------B---oE-o--MM----o-o------M---B----------M---M---------------X---X---|---?--o---E------o-----
----T--B--X--------?-----M---T|--T--o----M-B---------E----------X-------EX--?----Mo-------oB----XE--------------T-----?X-------Eo-o--?--?o-----T---------MME-------X------o---TX---E-E--------X-B-------
--o?--?------T-------------TE-|---|E-------T---Xo----M-------M---XXB-oX-----------------T------B-o-----o----------|X---------E----X--------E--?o?----E---------o---------------|?-----------|---B-o-----
--------|---B-T?-o-|TB--E------X---?--------M--X---------T-----E------X-----------E---|--|----------------|------------M----M-B-------B--?o----E----?---B--------B----o-----------E--o----o----|--o-oX--
--XM--------M?-T----To-X-----T----------X-------E--XTo--B------X----------X---E------B----B-o------o-|-M---?--?----X--------o-o-----|?----------------|-------M------|--------|----|----?X-----o--M-E--v
--------?------E----XE----------------------------|-------------T---------|--------------Bo|---?M---B---o-----X--XM----B-------?-----T-------------T---------M-BT----X------------E--|---T----E-----B-Mf
--------------o---X?--To-T----------------------M?To-----o-B--B--------??B--------B-------X----------X-T--------B--X?-o-?-----BE-------?-----B------------T------M----X-?---o-o--B----M-----------?----f
-----M----M--------------T---------------M-----|---E-----B----|B----o-M-M--?--E----|---o--M------|-|----?------?-|--M----o-----------?---?------B--------M-E---o----?-----?------EX------------B---X---f
--?------------X-XB----T----------|--?--|------o--------o------|-?-------B--B--E------X---XE--B---X-X-----|-|--?-o----?--------T----X--T--------------E--T-o------M-B------B--o-E-------T?---B-----T---f
----B-------E-----------------BTX-----B----X------T-------B--------------E------o---M--E--------|----B-----B--------M------T?--B-X---M--M--o-----o--T--------oX--??--T----?------B-B----E-|---o?-------f
-------------------------------------B--?--|B----M-----E---E---M---?---o----?-------B-------E----B----M--------------X----M----X---------B---o---E----o-----------E-X-EM--|--------------?-TM------B--Tf
mo----B---M------T-E----------M|X-?--o-------B-----E-----B-----X-------?-X----?||------------------BM-----B-B----------------XB-----|------X---X--X--o-----X?-------XE|--------------------?----M-----BX
XXXXXXXTXEXXXXMXXXXEXXXXXXXoXXXXTXXXT-XXXBX|XXXXX?XXEMEXXXBXXXXXXXXXXXXXXXXXXXXXBX?ooXXXoX?XXXXXBXXXXXXX-XoXXXXX?XXXXXXXXMXXXXX-XXXXXXoXXE?XXXXXXXXXTXXXXXXXEXXXX|EXXXXXXXXXXXoXXXXXXXXXX?XXEXXXooTX-BXX
