--oo-E----------X-------------?----o-E-M--E-----E----X------------MM-E-----MB-----|--|---------------XEB----------------X--EE---E-B----oXo-E-XB-------X--M----B-------|-o--B------oTo-X----M-BEoB---B---
----o---M------E|?-XM---B-E?-o-------E--BX--M------T--?--?T----------M-|-----X-E--MoT--TT-------X---------X--|-o---T---M------o---oX------------------B------|o-?---oE------X--|----o-?-------X--X|-----
---?MX-T---------?-----------E--?BT---|-?--?-oo--------|-------X-------|T-Mo-------MX---EB--------TT---------M----o-BE----?--E----------EM---XoX--T------E---T-MXE|-|------------T-X--o-Mo--B---X-----o-
-oM---T--o|-|--o--o-o-E-------?--XB---?--?-----|---E--o------|---|o----EE--o-------T-X--------------XM-------------o--oB--B--------|--E-----B--|--B-X-|-Eo--M-----------------B-------------------------
----T-----------B---?--M------?M---M-T-------oEB-B---M--?--B?------E------M|?-M--BM|-------?---X---X----------E--o-BM-----B-M--?--?----E-----------E|----E|B?M--------------------B-----B-?E------------
--?E--|---M-B---|T---M---o--o---X-----?------T-----M--------M-oM-M----------E------?oX---------T-----E------------B-----Bo---------?-------E--|-?---E?Mo------|---------XE---M---o-o-----T----Eo?-o--X--
-----TE|ME-------B--M-M---?--M--EB-X-----o--B----X---?--|--o--------MM----M---X--?-E|-XM--M----|-B------E-?--MX-------------?-----B--?-------M----EB----E?----------o----------------?o---X|-T-B----M---
--------------B---T-?--B-|TMME---B--?----X-?-o--------MB--------o----?X-X---X----B---|-----T-?---|-M-------|--o---M---X---B--E----------MMo--B------ToE-----?---M------------------EX-B----B-E--|---M--v
--------|-------|X----E--MB-MX----B--------?----------o-|--------B----?--o--T-----E------------------B---X-B----T--M-----------X----o-o-?-o-?--|B---o--|Xo-?E--------oE--XM------X----o-?-----M--X---XMf
--X-----------o-X-----------M--o-----?-M-X|--M-?T-Eo-E|X---M|-M------E---E---?--o|------------E---?X|X--E----XMB|---T--TM---------o------------E-----|------M----To-----T--------M----|--BT------------f
-B--oT-M-T-B-E?-E--o-----|---B-------?-X--E-o-------E|--X---|--o--To-----|--|--?--E-B-----------??---?|-o--E--B-----------E---?----XM-------Eo--EX?----M--BX-E-------oo-----?X--M-?-o----?-E---E-------f
-----M---X----o--------M----------?-------B------?o-------T-E-E--o---X-|-X|-----B-------?----X-----------B-E---B-------T-X-TT----M----T----------X-o------M--X-T-X----M|------T--------??-T---M--|--XM-f
--E--E--EB-B--------------B---|--E---o---B---B---TXo----------MM---|----BEB--X-BB---EE-----------M--?-oB------------------|-?--o-----M--X--M--?-----E?E-E-BX-----M-?o-oE---?-|M--o--------M-----BB-|-Bof
----E---T??M---------?--------o----------?--------EM-T-------------M------T-M----E----X--------X--o-ME---?|---|-X-B--BE----E------XTM-o-TXM--X---------?--ET---E--o-M---|-B-----oo-------X-T----o------f
m-----?--EM---------XT----M---M----M---BT--------B?---------E--E----E---o-----?E----E-|-E--------o--------------X--?-----------X--------?--------|-----B-------oo-E-----X-?T-M---------X-|----?X------TX
XX-XX|BXMXXXXXXXXXXXXX|XMXXXXXXXXEEXXXXXXXXXXXXXXXXXXXXXEoXXXXXXEXXXXMXXXXXXEXXXEooMBXXXXXXMXXXXXXXXBXXXXB-XXXXoXXXBXXXBoXXXXXXXX-XTXXXMXXXXEXM-XXMXXXXXXXXXXMXXXXEXXXXXXXXXXXXXXXXMXXXXXXX-XXXXXXX-o-XX
