--------------------------------------------------------------------------------------------------------------------------------------------------------------------------------------------------------
--------------------------------------------------------------------------------------------------------------------------------------------------------------------------------------------------------
--------------------------------------------------------------------------------------------------------------------------------------------------------------------------------------------------------
--------------------------------------------------------------------------------------------------------------------------------------------------------------------------------------------------------
---------------------------------------------------------XX---o---------------------?---------------------------------------X-M-------------------------------------------------------------------------
------------------------------------------------------------------X--------------------------------------------------------XX----------------------X----------------------------------------------------
-----------------------------------------------------------------XX-------------------------------------------------------XXX---------------------XX----------------------------------------------------
----------------------------------------------------------------XXX------------------------------------------------------XXXX--------------------XXX---------------------------------------------------v
---------------------------------------------------------------XXXX-----------------------------------------------------XXXXX-------------------XXXX---------------------------------------------------f
--------------------------------------------------------------XXXXX----------------X-------------------X---------------XXXXXX------------------XXXXX----------------------------------------X----------f
----------------B--------------------------------------------XXXXXX---------------------------------------------------XXXXXXX-----------------XXXXXX---------------------------------------------------f
------------------------------------------------------------XXXXXXX--------------------------------------------------XXXXXXXX----------------XXXXXXX---------------------------------------------------f
----------------------------------------------------o------XXXXXXXX-------------------------------T-----------------XXXXXXXXX---------------XXXXXXXX---------------------------------------------------f
----------------------------------------------------------XXXXXXXXX-------------------------------|----------------XXXXXXXXXX--------------XXXXXXXXX---------------------------------------------------f
m------------------------------------------------o-------XXXXXXXXXX----------------------E--------|---------------XXXXXXXXXXX----X--------XXXXXXXXXX---------------------------------------------------X
XXXXXXXXXXXXXXXXXXXXXXXXXXXXXXXXXXXXXXXXXXXXXXXXXXXXXXXXXXXXXXXXXXXXXXXXXXXXXXXXXXXXXXXXXXXXXXXXXX|XXXXXXXXXXXXXXXXXXXXXXXXXXXXXXXXXXXXXXXXXXXXXXXXXXXXXXXXXXXXXXXXXXXXXXXXXXXXXXXXXXXXXXXXXXX-----XXXXX
