------X-X----X------T---M?-E-E|M-|----E---|---oT-?---oB-BB-o--MBB--oX-oMM-o-?MT-?---o-XB-M-M---?-|E-MT-BXTXT--E------o-B--T-B--|E-------BB----oo-|------TX----E---?M?T?--o-o|---XX------Mo--B-||---XXX--
---------B-E--MX|--o-oE---BEM---?---B--|----|E-oX--B----E--X?-M?----M-B--o-------X---MMX------T-o--To-MT---E--M?-T---T-??----E--------T----M---M|----|?-----o-|E-----oo--TE-?---?B-E----|--?-Mo---B-X---
-Mo-o-M--|-M--|-X|--T--|-E-B-----o-E-B---B-?--o|-MoM?----|o--------T|M---?MoX----oX--MEXEo----M|--EE-EM-XB------T------M--X-oX--M?--M--?-B?M---X-BT|B--B----|---X----?E----?-oT|----EM-X---?EM|-o-T-E|--
-M---M-X|----E---?-E-|MM----o|------T?-oo-B-E---oM--||-MX-X-M-o-o----B---|--oo-||-EM--T-|?|o-?---------TT-MBT--MBo-oEXB------B-MX------B--X----?BM---oXM-X|-|----X--o-B-E-E--X--B-EE--B--ETEB--TE---?---
-M-||-TBX-E?o--?-X-oo--?E|--M----BTT-XT--M--oB-X?B|XBX----|EB-----XoM?-M----E--?T-B-?---X---|--E-E|B|--E-?-M|E-T-E-?-|-o--XXT---?E-|BX---XM--o----M---M--XE--Mo----B--o-o-E--B?-E---E---?------B-X--T-T-
-M----?---E-----M---E--M-----oM---T--B--|--M----M-M--oT--MT-----B---B?T-E--M-B----B|X----B--------X---X-----M---TMB?-B|T---XB-XM-oX---?-?--T?---TMB--X|----------ME-B---M-?-?TB--E------M-------?-------
---X-----|-T-T--T--XX-o-BTXXXMo-T-B?E--B--??X-E-?---E-M-X--E----EX?T-EBEE---E-----||----M-X----o---|--B-Eo----B?E--M---o-?T------T-----X--M-BB----T-XB-------E--o-?-T----|B|T--|---??--E-----TX-----|---
---MM|-B-M--EX------?M--B-?o-B----??-E--|M?----|-o-?---?-?|?XTo-X-XEo-BM----o----ME--MoE-----BE?MT------E--E?--o--BM-o--M-------o-X--------?B--|?--|--X--T---XM-------M----T-|-Eoo-----------BBT-?---T-v
----X|-EE----?--M?--X----E-Mo?|-?--X---M-X-M-M|E--T-B--X-----E--?--E?o---M-TM-?-M-----?-E--XM-EM--TMo-E-------B-|M--?E-------o?----|---|-TXM--X-----|-M|X--?-M--|o-o-B-|T-----?E-?-EB--B--M-XT-----MEEBf
---o--TM|B?oTo-o----B--X---M-T---M--|B-oE-?o--XE-X--|B-X-?---B--TX?----M-E---|--E-?-B---E|----|ooTX|--|----M---X-B----|?-?o----M-o-o--B-XT---|--X------T--E-oT--T---------E-|--M-?T-B-X-B-M|-|-----EET-f
---B---E----------EB----?--E---XX-|---B?T|------oT-|-TE-oM-X--------?----XT----X-?-BoE------M--XM----T?-------M--BMX?--|?|-o|---E-----?X----M-E|oMT-oB-----|-?X--BE--E-EMEo-TB-----T--TX-X?-B--ME---oE?f
--M--MX----o--M|-|o--?X-------E-TM------B-?||-Mo-oT-E?M--X----B|-T-oTEB|--T--M-|-?-X-----MM-|EE------|T--B-MEE-------M--E------M-|X-XXEEM-MB-T-X-M-|--EM|-Eo-oM-ME--BXM--M?|--T--|-E-----X-T|T-----E--Tf
--M--T--oM---M-XB--T-oE----||--XT-----X--BE-|B|--EM-E-T-X?-?---?-ME-T||----E---T--BM--B-E-|?B--E----??-|oE-----T-o--?---oBo-T-?-----ETo-----E-X-MB---BB-o---BT-?-E?B---M--BM----X----|------X-M-E-To-oTf
------E-M-oB|---B-o-B-T--MXXTT-B----X-o---o|-o-----BM-|EBX---To-o--||TT?o-M---E---o--B--|-|---M------MBT|-|-B-oX--|-o---?-?--B-BB-TT--o--T|B|--EEo||-|-----o|----M?---BX-B-?-EET-T--?MB-M-XX--T?-T-----f
m----oX?M---------??--|---MXT-B---XX-E--T-M|oo--M---M-M---TBM?B----EM-|---|-------|-M-o-M-----B-||-E---|?Xo---XE-|--|?X-o--oXXMo---|o--oo-?----T?EBT---------X-M--M-|--o-T---|---XMXM-o?-BT-B|E?E-BXB--X
XXXXXXXXXXXXXXXXXXXXXXXXXXXXXXXXXXXXXXXXXXXXXXXXXXXXXXXXXXXXXXXXXXXXXXXXXXXXXXXXXXXXXXXXXXXXXXXXXXXXXXXXXXXXXXXXXXXXXXXXXXXXXXXXXXXXXXXXXXXXXXXXXXXXXXXXXXXXXXXXXXXXXXXXXXXXXXXXXXXXXXXXXXXXXXXXXXXXXXXX
